%gen_inp
%ename onionhangul
%cname 洋蔥韓文形碼
%encoding UTF-8
%selkey 1234567890
%keyname begin
a Ａ
b Ｂ
c Ｃ
d Ｄ
e Ｅ
f Ｆ
g Ｇ
h Ｈ
i Ｉ
j Ｊ
k Ｋ
l Ｌ
m Ｍ
n Ｎ
o Ｏ
p Ｐ
q Ｑ
r Ｒ
s Ｓ
t Ｔ
u Ｕ
v Ｖ
w Ｗ
x Ｘ
y Ｙ
z Ｚ
/ /
%keyname end
%chardef begin
/	/
###韓文總起始
##韓文音節HangulSyllables起始
#諺文使用簡根啟始
ykf	갂
ykv	갃
ykk	갅
ykg	갆
ykj	갉
ykn	갊
ykr	갋
ykp	갌
ykt	갍
yki	갎
ywk	갏
ykh	값
ykm	갔
yhf	갞
yhv	갟
yhk	갡
yhg	갢
yhj	갥
yhn	갦
yhr	갧
yhp	갨
yht	갩
yhi	갪
ywh	갫
yhh	갮
yhm	갰
yff	갺
yfv	갻
yfk	갽
yfg	갾
yfj	걁
yfn	걂
yfr	걃
yfp	걄
yft	걅
yfi	걆
ywf	걇
yfh	걊
yfm	걌
yo	걔
yoy	걕
yof	걖
yov	걗
yol	걘
yok	걙
yog	걚
yoc	걛
yos	걜
yoj	걝
yon	걞
yor	걟
yop	걠
yot	걡
yoi	걢
ywo	걣
yoo	걤
yoa	걥
yoh	걦
yob	걧
yom	걨
yoq	걩
you	걪
yod	걫
yoz	걬
yoe	걭
yox	걮
yow	걯
yjf	걲
yjv	걳
yjk	걵
yjg	걶
yjj	걹
yjn	걺
yjr	걻
yjp	걼
yjt	걽
yji	걾
ywj	걿
yjh	겂
yjm	겄
ypf	겎
ypv	겏
ypk	겑
ypg	겒
ypj	겕
ypn	겖
ypr	겗
ypp	겘
ypt	겙
ypi	겚
ywp	겛
yph	겞
ypm	겠
ygf	겪
ygv	겫
ygk	겭
ygg	겮
ygj	겱
ygn	겲
ygr	겳
ygp	겴
ygt	겵
ygi	겶
ywg	겷
ygh	겺
ygm	겼
yq	계
yqy	곅
yqf	곆
yqv	곇
yql	곈
yqk	곉
yqg	곊
yqc	곋
yqs	곌
yqj	곍
yqn	곎
yqr	곏
yqp	곐
yqt	곑
yqi	곒
ywq	곓
yqo	곔
yqa	곕
yqh	곖
yqb	곗
yqm	곘
yqq	곙
yqu	곚
yqd	곛
yqz	곜
yqe	곝
yqx	곞
yqw	곟
ynf	곢
ynv	곣
ynk	곥
yng	곦
ynj	곩
ynn	곪
ynr	곫
ynp	곬
ynt	곭
yni	곮
ywn	곯
ynh	곲
ynm	곴
ye	과
yey	곽
yef	곾
yev	곿
yel	관
yek	괁
yeg	괂
yec	괃
yes	괄
yej	괅
yen	괆
yer	괇
yep	괈
yet	괉
yei	괊
ywe	괋
yeo	괌
yea	괍
yeh	괎
yeb	괏
yem	괐
yeq	광
yeu	괒
yed	괓
yez	괔
yee	괕
yex	괖
yew	괗
ys	괘
ysy	괙
ysf	괚
ysv	괛
ysl	괜
ysk	괝
ysg	괞
ysc	괟
yss	괠
ysj	괡
ysn	괢
ysr	괣
ysp	괤
yst	괥
ysi	괦
yws	괧
yso	괨
ysa	괩
ysh	괪
ysb	괫
ysm	괬
ysq	괭
ysu	괮
ysd	괯
ysz	괰
yse	괱
ysx	괲
ysw	괳
yx	괴
yxy	괵
yxf	괶
yxv	괷
yxl	괸
yxk	괹
yxg	괺
yxc	괻
yxs	괼
yxj	괽
yxn	괾
yxr	괿
yxp	굀
yxt	굁
yxi	굂
ywx	굃
yxo	굄
yxa	굅
yxh	굆
yxb	굇
yxm	굈
yxq	굉
yxu	굊
yxd	굋
yxz	굌
yxe	굍
yxx	굎
yxw	굏
ymf	굒
ymv	굓
ymk	굕
ymg	굖
ymj	굙
ymn	굚
ymr	굛
ymp	굜
ymt	굝
ymi	굞
ywm	굟
ymh	굢
ymm	굤
ytf	굮
ytv	굯
ytk	굱
ytg	굲
ytj	굵
ytn	굶
ytr	굷
ytp	굸
ytt	굹
yti	굺
ywt	굻
yth	굾
ytm	궀
ya	궈
yay	궉
yaf	궊
yav	궋
yal	권
yak	궍
yag	궎
yac	궏
yas	궐
yaj	궑
yan	궒
yar	궓
yap	궔
yat	궕
yai	궖
ywa	궗
yao	궘
yaa	궙
yah	궚
yab	궛
yam	궜
yaq	궝
yau	궞
yad	궟
yaz	궠
yae	궡
yax	궢
yaw	궣
yz	궤
yzy	궥
yzf	궦
yzv	궧
yzl	궨
yzk	궩
yzg	궪
yzc	궫
yzs	궬
yzj	궭
yzn	궮
yzr	궯
yzp	궰
yzt	궱
yzi	궲
ywz	궳
yzo	궴
yza	궵
yzh	궶
yzb	궷
yzm	궸
yzq	궹
yzu	궺
yzd	궻
yzz	궼
yze	궽
yzx	궾
yzw	궿
yd	귀
ydy	귁
ydf	귂
ydv	귃
ydl	귄
ydk	귅
ydg	귆
ydc	귇
yds	귈
ydj	귉
ydn	귊
ydr	귋
ydp	귌
ydt	귍
ydi	귎
ywd	귏
ydo	귐
yda	귑
ydh	귒
ydb	귓
ydm	귔
ydq	귕
ydu	귖
ydd	귗
ydz	귘
yde	귙
ydx	귚
ydw	귛
yrf	귞
yrv	귟
yrk	귡
yrg	귢
yrj	귥
yrn	귦
yrr	귧
yrp	귨
yrt	귩
yri	귪
ywr	귫
yrh	귮
yrm	귰
yvf	귺
yvv	귻
yvk	귽
yvg	귾
yvj	긁
yvn	긂
yvr	긃
yvp	긄
yvt	긅
yvi	긆
ywv	긇
yvh	긊
yvm	긌
yl	긔
yly	긕
ylf	긖
ylv	긗
yll	긘
ylk	긙
ylg	긚
ylc	긛
yls	긜
ylj	긝
yln	긞
ylr	긟
ylp	긠
ylt	긡
yli	긢
ywl	긣
ylo	긤
yla	긥
ylh	긦
ylb	긧
ylm	긨
ylq	긩
ylu	긪
yld	긫
ylz	긬
yle	긭
ylx	긮
ylw	긯
yif	긲
yiv	긳
yik	긵
yig	긶
yij	긹
yin	긺
yir	긻
yip	긼
yit	긽
yii	긾
ywi	긿
yih	깂
yim	깄
#s2
fk	까
fky	깍
fkf	깎
fkv	깏
fkl	깐
fkk	깑
fkg	깒
fkc	깓
fks	깔
fkj	깕
fkn	깖
fkr	깗
fkp	깘
fkt	깙
fki	깚
fwk	깛
fko	깜
fka	깝
fkh	깞
fkb	깟
fkm	깠
fkq	깡
fku	깢
fkd	깣
fkz	깤
fke	깥
fkx	깦
fkw	깧
fh	깨
fhy	깩
fhf	깪
fhv	깫
fhl	깬
fhk	깭
fhg	깮
fhc	깯
fhs	깰
fhj	깱
fhn	깲
fhr	깳
fhp	깴
fht	깵
fhi	깶
fwh	깷
fho	깸
fha	깹
fhh	깺
fhb	깻
fhm	깼
fhq	깽
fhu	깾
fhd	깿
fhz	꺀
fhe	꺁
fhx	꺂
fhw	꺃
ff	꺄
ffy	꺅
fff	꺆
ffv	꺇
ffl	꺈
ffk	꺉
ffg	꺊
ffc	꺋
ffs	꺌
ffj	꺍
ffn	꺎
ffr	꺏
ffp	꺐
fft	꺑
ffi	꺒
fwf	꺓
ffo	꺔
ffa	꺕
ffh	꺖
ffb	꺗
ffm	꺘
ffq	꺙
ffu	꺚
ffd	꺛
ffz	꺜
ffe	꺝
ffx	꺞
ffw	꺟
fo	꺠
foy	꺡
fof	꺢
fov	꺣
fol	꺤
fok	꺥
fog	꺦
foc	꺧
fos	꺨
foj	꺩
fon	꺪
for	꺫
fop	꺬
fot	꺭
foi	꺮
fwo	꺯
foo	꺰
foa	꺱
foh	꺲
fob	꺳
fom	꺴
foq	꺵
fou	꺶
fod	꺷
foz	꺸
foe	꺹
fox	꺺
fow	꺻
fj	꺼
fjy	꺽
fjf	꺾
fjv	꺿
fjl	껀
fjk	껁
fjg	껂
fjc	껃
fjs	껄
fjj	껅
fjn	껆
fjr	껇
fjp	껈
fjt	껉
fji	껊
fwj	껋
fjo	껌
fja	껍
fjh	껎
fjb	껏
fjm	껐
fjq	껑
fju	껒
fjd	껓
fjz	껔
fje	껕
fjx	껖
fjw	껗
fp	께
fpy	껙
fpf	껚
fpv	껛
fpl	껜
fpk	껝
fpg	껞
fpc	껟
fps	껠
fpj	껡
fpn	껢
fpr	껣
fpp	껤
fpt	껥
fpi	껦
fwp	껧
fpo	껨
fpa	껩
fph	껪
fpb	껫
fpm	껬
fpq	껭
fpu	껮
fpd	껯
fpz	껰
fpe	껱
fpx	껲
fpw	껳
fg	껴
fgy	껵
fgf	껶
fgv	껷
fgl	껸
fgk	껹
fgg	껺
fgc	껻
fgs	껼
fgj	껽
fgn	껾
fgr	껿
fgp	꼀
fgt	꼁
fgi	꼂
fwg	꼃
fgo	꼄
fga	꼅
fgh	꼆
fgb	꼇
fgm	꼈
fgq	꼉
fgu	꼊
fgd	꼋
fgz	꼌
fge	꼍
fgx	꼎
fgw	꼏
fq	꼐
fqy	꼑
fqf	꼒
fqv	꼓
fql	꼔
fqk	꼕
fqg	꼖
fqc	꼗
fqs	꼘
fqj	꼙
fqn	꼚
fqr	꼛
fqp	꼜
fqt	꼝
fqi	꼞
fwq	꼟
fqo	꼠
fqa	꼡
fqh	꼢
fqb	꼣
fqm	꼤
fqq	꼥
fqu	꼦
fqd	꼧
fqz	꼨
fqe	꼩
fqx	꼪
fqw	꼫
fn	꼬
fny	꼭
fnf	꼮
fnv	꼯
fnl	꼰
fnk	꼱
fng	꼲
fnc	꼳
fns	꼴
fnj	꼵
fnn	꼶
fnr	꼷
fnp	꼸
fnt	꼹
fni	꼺
fwn	꼻
fno	꼼
fna	꼽
fnh	꼾
fnb	꼿
fnm	꽀
fnq	꽁
fnu	꽂
fnd	꽃
fnz	꽄
fne	꽅
fnx	꽆
fnw	꽇
fe	꽈
fey	꽉
fef	꽊
fev	꽋
fel	꽌
fek	꽍
feg	꽎
fec	꽏
fes	꽐
fej	꽑
fen	꽒
fer	꽓
fep	꽔
fet	꽕
fei	꽖
fwe	꽗
feo	꽘
fea	꽙
feh	꽚
feb	꽛
fem	꽜
feq	꽝
feu	꽞
fed	꽟
fez	꽠
fee	꽡
fex	꽢
few	꽣
fs	꽤
fsy	꽥
fsf	꽦
fsv	꽧
fsl	꽨
fsk	꽩
fsg	꽪
fsc	꽫
fss	꽬
fsj	꽭
fsn	꽮
fsr	꽯
fsp	꽰
fst	꽱
fsi	꽲
fws	꽳
fso	꽴
fsa	꽵
fsh	꽶
fsb	꽷
fsm	꽸
fsq	꽹
fsu	꽺
fsd	꽻
fsz	꽼
fse	꽽
fsx	꽾
fsw	꽿
fx	꾀
fxy	꾁
fxf	꾂
fxv	꾃
fxl	꾄
fxk	꾅
fxg	꾆
fxc	꾇
fxs	꾈
fxj	꾉
fxn	꾊
fxr	꾋
fxp	꾌
fxt	꾍
fxi	꾎
fwx	꾏
fxo	꾐
fxa	꾑
fxh	꾒
fxb	꾓
fxm	꾔
fxq	꾕
fxu	꾖
fxd	꾗
fxz	꾘
fxe	꾙
fxx	꾚
fxw	꾛
fm	꾜
fmy	꾝
fmf	꾞
fmv	꾟
fml	꾠
fmk	꾡
fmg	꾢
fmc	꾣
fms	꾤
fmj	꾥
fmn	꾦
fmr	꾧
fmp	꾨
fmt	꾩
fmi	꾪
fwm	꾫
fmo	꾬
fma	꾭
fmh	꾮
fmb	꾯
fmm	꾰
fmq	꾱
fmu	꾲
fmd	꾳
fmz	꾴
fme	꾵
fmx	꾶
fmw	꾷
ft	꾸
fty	꾹
ftf	꾺
ftv	꾻
ftl	꾼
ftk	꾽
ftg	꾾
ftc	꾿
fts	꿀
ftj	꿁
ftn	꿂
ftr	꿃
ftp	꿄
ftt	꿅
fti	꿆
fwt	꿇
fto	꿈
fta	꿉
fth	꿊
ftb	꿋
ftm	꿌
ftq	꿍
ftu	꿎
ftd	꿏
ftz	꿐
fte	꿑
ftx	꿒
ftw	꿓
fa	꿔
fay	꿕
faf	꿖
fav	꿗
fal	꿘
fak	꿙
fag	꿚
fac	꿛
fas	꿜
faj	꿝
fan	꿞
far	꿟
fap	꿠
fat	꿡
fai	꿢
fwa	꿣
fao	꿤
faa	꿥
fah	꿦
fab	꿧
fam	꿨
faq	꿩
fau	꿪
fad	꿫
faz	꿬
fae	꿭
fax	꿮
faw	꿯
fz	꿰
fzy	꿱
fzf	꿲
fzv	꿳
fzl	꿴
fzk	꿵
fzg	꿶
fzc	꿷
fzs	꿸
fzj	꿹
fzn	꿺
fzr	꿻
fzp	꿼
fzt	꿽
fzi	꿾
fwz	꿿
fzo	뀀
fza	뀁
fzh	뀂
fzb	뀃
fzm	뀄
fzq	뀅
fzu	뀆
fzd	뀇
fzz	뀈
fze	뀉
fzx	뀊
fzw	뀋
fd	뀌
fdy	뀍
fdf	뀎
fdv	뀏
fdl	뀐
fdk	뀑
fdg	뀒
fdc	뀓
fds	뀔
fdj	뀕
fdn	뀖
fdr	뀗
fdp	뀘
fdt	뀙
fdi	뀚
fwd	뀛
fdo	뀜
fda	뀝
fdh	뀞
fdb	뀟
fdm	뀠
fdq	뀡
fdu	뀢
fdd	뀣
fdz	뀤
fde	뀥
fdx	뀦
fdw	뀧
fr	뀨
fry	뀩
frf	뀪
frv	뀫
frl	뀬
frk	뀭
frg	뀮
frc	뀯
frs	뀰
frj	뀱
frn	뀲
frr	뀳
frp	뀴
frt	뀵
fri	뀶
fwr	뀷
fro	뀸
fra	뀹
frh	뀺
frb	뀻
frm	뀼
frq	뀽
fru	뀾
frd	뀿
frz	끀
fre	끁
frx	끂
frw	끃
fv	끄
fvy	끅
fvf	끆
fvv	끇
fvl	끈
fvk	끉
fvg	끊
fvc	끋
fvs	끌
fvj	끍
fvn	끎
fvr	끏
fvp	끐
fvt	끑
fvi	끒
fwv	끓
fvo	끔
fva	끕
fvh	끖
fvb	끗
fvm	끘
fvq	끙
fvu	끚
fvd	끛
fvz	끜
fve	끝
fvx	끞
fvw	끟
fl	끠
fly	끡
flf	끢
flv	끣
fll	끤
flk	끥
flg	끦
flc	끧
fls	끨
flj	끩
fln	끪
flr	끫
flp	끬
flt	끭
fli	끮
fwl	끯
flo	끰
fla	끱
flh	끲
flb	끳
flm	끴
flq	끵
flu	끶
fld	끷
flz	끸
fle	끹
flx	끺
flw	끻
fi	끼
fiy	끽
fif	끾
fiv	끿
fil	낀
fik	낁
fig	낂
fic	낃
fis	낄
fij	낅
fin	낆
fir	낇
fip	낈
fit	낉
fii	낊
fwi	낋
fio	낌
fia	낍
fih	낎
fib	낏
fim	낐
fiq	낑
fiu	낒
fid	낓
fiz	낔
fie	낕
fix	낖
fiw	낗
#s3
lkf	낚
lkv	낛
lkk	낝
lkg	낞
lkj	낡
lkn	낢
lkr	낣
lkp	낤
lkt	낥
lki	낦
lwk	낧
lkh	낪
lkm	났
lhf	낶
lhv	낷
lhk	낹
lhg	낺
lhj	낽
lhn	낾
lhr	낿
lhp	냀
lht	냁
lhi	냂
lwh	냃
lhh	냆
lhm	냈
lff	냒
lfv	냓
lfk	냕
lfg	냖
lfj	냙
lfn	냚
lfr	냛
lfp	냜
lft	냝
lfi	냞
lwf	냟
lfh	냢
lfm	냤
lo	냬
loy	냭
lof	냮
lov	냯
lol	냰
lok	냱
log	냲
loc	냳
los	냴
loj	냵
lon	냶
lor	냷
lop	냸
lot	냹
loi	냺
lwo	냻
loo	냼
loa	냽
loh	냾
lob	냿
lom	넀
loq	넁
lou	넂
lod	넃
loz	넄
loe	넅
lox	넆
low	넇
ljf	넊
ljv	넋
ljk	넍
ljg	넎
ljj	넑
ljn	넒
ljr	넓
ljp	넔
ljt	넕
lji	넖
lwj	넗
ljh	넚
ljm	넜
lpf	넦
lpv	넧
lpk	넩
lpg	넪
lpj	넭
lpn	넮
lpr	넯
lpp	넰
lpt	넱
lpi	넲
lwp	넳
lph	넶
lpm	넸
lgf	녂
lgv	녃
lgk	녅
lgg	녆
lgj	녉
lgn	녊
lgr	녋
lgp	녌
lgt	녍
lgi	녎
lwg	녏
lgh	녒
lgm	녔
lq	녜
lqy	녝
lqf	녞
lqv	녟
lql	녠
lqk	녡
lqg	녢
lqc	녣
lqs	녤
lqj	녥
lqn	녦
lqr	녧
lqp	녨
lqt	녩
lqi	녪
lwq	녫
lqo	녬
lqa	녭
lqh	녮
lqb	녯
lqm	녰
lqq	녱
lqu	녲
lqd	녳
lqz	녴
lqe	녵
lqx	녶
lqw	녷
lnf	녺
lnv	녻
lnk	녽
lng	녾
lnj	놁
lnn	놂
lnr	놃
lnp	놄
lnt	놅
lni	놆
lwn	놇
lnh	놊
lnm	놌
le	놔
ley	놕
lef	놖
lev	놗
lel	놘
lek	놙
leg	놚
lec	놛
les	놜
lej	놝
len	놞
ler	놟
lep	놠
let	놡
lei	놢
lwe	놣
leo	놤
lea	놥
leh	놦
leb	놧
lem	놨
leq	놩
leu	놪
led	놫
lez	놬
lee	놭
lex	놮
lew	놯
ls	놰
lsy	놱
lsf	놲
lsv	놳
lsl	놴
lsk	놵
lsg	놶
lsc	놷
lss	놸
lsj	놹
lsn	놺
lsr	놻
lsp	놼
lst	놽
lsi	놾
lws	놿
lso	뇀
lsa	뇁
lsh	뇂
lsb	뇃
lsm	뇄
lsq	뇅
lsu	뇆
lsd	뇇
lsz	뇈
lse	뇉
lsx	뇊
lsw	뇋
lx	뇌
lxy	뇍
lxf	뇎
lxv	뇏
lxl	뇐
lxk	뇑
lxg	뇒
lxc	뇓
lxs	뇔
lxj	뇕
lxn	뇖
lxr	뇗
lxp	뇘
lxt	뇙
lxi	뇚
lwx	뇛
lxo	뇜
lxa	뇝
lxh	뇞
lxb	뇟
lxm	뇠
lxq	뇡
lxu	뇢
lxd	뇣
lxz	뇤
lxe	뇥
lxx	뇦
lxw	뇧
lmf	뇪
lmv	뇫
lmk	뇭
lmg	뇮
lmj	뇱
lmn	뇲
lmr	뇳
lmp	뇴
lmt	뇵
lmi	뇶
lwm	뇷
lmh	뇺
lmm	뇼
ltf	눆
ltv	눇
ltk	눉
ltg	눊
ltj	눍
ltn	눎
ltr	눏
ltp	눐
ltt	눑
lti	눒
lwt	눓
lth	눖
ltm	눘
la	눠
lay	눡
laf	눢
lav	눣
lal	눤
lak	눥
lag	눦
lac	눧
las	눨
laj	눩
lan	눪
lar	눫
lap	눬
lat	눭
lai	눮
lwa	눯
lao	눰
laa	눱
lah	눲
lab	눳
lam	눴
laq	눵
lau	눶
lad	눷
laz	눸
lae	눹
lax	눺
law	눻
lz	눼
lzy	눽
lzf	눾
lzv	눿
lzl	뉀
lzk	뉁
lzg	뉂
lzc	뉃
lzs	뉄
lzj	뉅
lzn	뉆
lzr	뉇
lzp	뉈
lzt	뉉
lzi	뉊
lwz	뉋
lzo	뉌
lza	뉍
lzh	뉎
lzb	뉏
lzm	뉐
lzq	뉑
lzu	뉒
lzd	뉓
lzz	뉔
lze	뉕
lzx	뉖
lzw	뉗
ld	뉘
ldy	뉙
ldf	뉚
ldv	뉛
ldl	뉜
ldk	뉝
ldg	뉞
ldc	뉟
lds	뉠
ldj	뉡
ldn	뉢
ldr	뉣
ldp	뉤
ldt	뉥
ldi	뉦
lwd	뉧
ldo	뉨
lda	뉩
ldh	뉪
ldb	뉫
ldm	뉬
ldq	뉭
ldu	뉮
ldd	뉯
ldz	뉰
lde	뉱
ldx	뉲
ldw	뉳
lrf	뉶
lrv	뉷
lrk	뉹
lrg	뉺
lrj	뉽
lrn	뉾
lrr	뉿
lrp	늀
lrt	늁
lri	늂
lwr	늃
lrh	늆
lrm	늈
lvf	늒
lvv	늓
lvk	늕
lvg	늖
lvj	늙
lvn	늚
lvr	늛
lvp	늜
lvt	늝
lvi	늞
lwv	늟
lvh	늢
lvm	늤
ll	늬
lly	늭
llf	늮
llv	늯
lll	늰
llk	늱
llg	늲
llc	늳
lls	늴
llj	늵
lln	늶
llr	늷
llp	늸
llt	늹
lli	늺
lwl	늻
llo	늼
lla	늽
llh	늾
llb	늿
llm	닀
llq	닁
llu	닂
lld	닃
llz	닄
lle	닅
llx	닆
llw	닇
lif	닊
liv	닋
lik	닍
lig	닎
lij	닑
lin	닒
lir	닓
lip	닔
lit	닕
lii	닖
lwi	닗
lih	닚
lim	닜
#s4
ckf	닦
ckv	닧
ckk	닩
ckg	닪
ckj	닭
ckn	닮
ckr	닯
ckp	닰
ckt	닱
cki	닲
cwk	닳
ckh	닶
ckm	닸
chf	댂
chv	댃
chk	댅
chg	댆
chj	댉
chn	댊
chr	댋
chp	댌
cht	댍
chi	댎
cwh	댏
chh	댒
chm	댔
cff	댞
cfv	댟
cfk	댡
cfg	댢
cfj	댥
cfn	댦
cfr	댧
cfp	댨
cft	댩
cfi	댪
cwf	댫
cfh	댮
cfm	댰
co	댸
coy	댹
cof	댺
cov	댻
col	댼
cok	댽
cog	댾
coc	댿
cos	덀
coj	덁
con	덂
cor	덃
cop	덄
cot	덅
coi	덆
cwo	덇
coo	덈
coa	덉
coh	덊
cob	덋
com	덌
coq	덍
cou	덎
cod	덏
coz	덐
coe	덑
cox	덒
cow	덓
cjf	덖
cjv	덗
cjk	덙
cjg	덚
cjj	덝
cjn	덞
cjr	덟
cjp	덠
cjt	덡
cji	덢
cwj	덣
cjh	덦
cjm	덨
cpf	덲
cpv	덳
cpk	덵
cpg	덶
cpj	덹
cpn	덺
cpr	덻
cpp	덼
cpt	덽
cpi	덾
cwp	덿
cph	뎂
cpm	뎄
cgf	뎎
cgv	뎏
cgk	뎑
cgg	뎒
cgj	뎕
cgn	뎖
cgr	뎗
cgp	뎘
cgt	뎙
cgi	뎚
cwg	뎛
cgh	뎞
cgm	뎠
cq	뎨
cqy	뎩
cqf	뎪
cqv	뎫
cql	뎬
cqk	뎭
cqg	뎮
cqc	뎯
cqs	뎰
cqj	뎱
cqn	뎲
cqr	뎳
cqp	뎴
cqt	뎵
cqi	뎶
cwq	뎷
cqo	뎸
cqa	뎹
cqh	뎺
cqb	뎻
cqm	뎼
cqq	뎽
cqu	뎾
cqd	뎿
cqz	돀
cqe	돁
cqx	돂
cqw	돃
cnf	돆
cnv	돇
cnk	돉
cng	돊
cnj	돍
cnn	돎
cnr	돏
cnp	돐
cnt	돑
cni	돒
cwn	돓
cnh	돖
cnm	돘
ce	돠
cey	돡
cef	돢
cev	돣
cel	돤
cek	돥
ceg	돦
cec	돧
ces	돨
cej	돩
cen	돪
cer	돫
cep	돬
cet	돭
cei	돮
cwe	돯
ceo	돰
cea	돱
ceh	돲
ceb	돳
cem	돴
ceq	돵
ceu	돶
ced	돷
cez	돸
cee	돹
cex	돺
cew	돻
cs	돼
csy	돽
csf	돾
csv	돿
csl	됀
csk	됁
csg	됂
csc	됃
css	됄
csj	됅
csn	됆
csr	됇
csp	됈
cst	됉
csi	됊
cws	됋
cso	됌
csa	됍
csh	됎
csb	됏
csm	됐
csq	됑
csu	됒
csd	됓
csz	됔
cse	됕
csx	됖
csw	됗
cx	되
cxy	됙
cxf	됚
cxv	됛
cxl	된
cxk	됝
cxg	됞
cxc	됟
cxs	될
cxj	됡
cxn	됢
cxr	됣
cxp	됤
cxt	됥
cxi	됦
cwx	됧
cxo	됨
cxa	됩
cxh	됪
cxb	됫
cxm	됬
cxq	됭
cxu	됮
cxd	됯
cxz	됰
cxe	됱
cxx	됲
cxw	됳
cmf	됶
cmv	됷
cmk	됹
cmg	됺
cmj	됽
cmn	됾
cmr	됿
cmp	둀
cmt	둁
cmi	둂
cwm	둃
cmh	둆
cmm	둈
ctf	둒
ctv	둓
ctk	둕
ctg	둖
ctj	둙
ctn	둚
ctr	둛
ctp	둜
ctt	둝
cti	둞
cwt	둟
cth	둢
ctm	둤
ca	둬
cay	둭
caf	둮
cav	둯
cal	둰
cak	둱
cag	둲
cac	둳
cas	둴
caj	둵
can	둶
car	둷
cap	둸
cat	둹
cai	둺
cwa	둻
cao	둼
caa	둽
cah	둾
cab	둿
cam	뒀
caq	뒁
cau	뒂
cad	뒃
caz	뒄
cae	뒅
cax	뒆
caw	뒇
cz	뒈
czy	뒉
czf	뒊
czv	뒋
czl	뒌
czk	뒍
czg	뒎
czc	뒏
czs	뒐
czj	뒑
czn	뒒
czr	뒓
czp	뒔
czt	뒕
czi	뒖
cwz	뒗
czo	뒘
cza	뒙
czh	뒚
czb	뒛
czm	뒜
czq	뒝
czu	뒞
czd	뒟
czz	뒠
cze	뒡
czx	뒢
czw	뒣
cd	뒤
cdy	뒥
cdf	뒦
cdv	뒧
cdl	뒨
cdk	뒩
cdg	뒪
cdc	뒫
cds	뒬
cdj	뒭
cdn	뒮
cdr	뒯
cdp	뒰
cdt	뒱
cdi	뒲
cwd	뒳
cdo	뒴
cda	뒵
cdh	뒶
cdb	뒷
cdm	뒸
cdq	뒹
cdu	뒺
cdd	뒻
cdz	뒼
cde	뒽
cdx	뒾
cdw	뒿
crf	듂
crv	듃
crk	듅
crg	듆
crj	듉
crn	듊
crr	듋
crp	듌
crt	듍
cri	듎
cwr	듏
crh	듒
crm	듔
cvf	듞
cvv	듟
cvk	듡
cvg	듢
cvj	듥
cvn	듦
cvr	듧
cvp	듨
cvt	듩
cvi	듪
cwv	듫
cvh	듮
cvm	듰
cl	듸
cly	듹
clf	듺
clv	듻
cll	듼
clk	듽
clg	듾
clc	듿
cls	딀
clj	딁
cln	딂
clr	딃
clp	딄
clt	딅
cli	딆
cwl	딇
clo	딈
cla	딉
clh	딊
clb	딋
clm	딌
clq	딍
clu	딎
cld	딏
clz	딐
cle	딑
clx	딒
clw	딓
cif	딖
civ	딗
cik	딙
cig	딚
cij	딝
cin	딞
cir	딟
cip	딠
cit	딡
cii	딢
cwi	딣
cih	딦
cim	딨
#s5
gk	따
gky	딱
gkf	딲
gkv	딳
gkl	딴
gkk	딵
gkg	딶
gkc	딷
gks	딸
gkj	딹
gkn	딺
gkr	딻
gkp	딼
gkt	딽
gki	딾
gwk	딿
gko	땀
gka	땁
gkh	땂
gkb	땃
gkm	땄
gkq	땅
gku	땆
gkd	땇
gkz	땈
gke	땉
gkx	땊
gkw	땋
gh	때
ghy	땍
ghf	땎
ghv	땏
ghl	땐
ghk	땑
ghg	땒
ghc	땓
ghs	땔
ghj	땕
ghn	땖
ghr	땗
ghp	땘
ght	땙
ghi	땚
gwh	땛
gho	땜
gha	땝
ghh	땞
ghb	땟
ghm	땠
ghq	땡
ghu	땢
ghd	땣
ghz	땤
ghe	땥
ghx	땦
ghw	땧
gf	땨
gfy	땩
gff	땪
gfv	땫
gfl	땬
gfk	땭
gfg	땮
gfc	땯
gfs	땰
gfj	땱
gfn	땲
gfr	땳
gfp	땴
gft	땵
gfi	땶
gwf	땷
gfo	땸
gfa	땹
gfh	땺
gfb	땻
gfm	땼
gfq	땽
gfu	땾
gfd	땿
gfz	떀
gfe	떁
gfx	떂
gfw	떃
go	떄
goy	떅
gof	떆
gov	떇
gol	떈
gok	떉
gog	떊
goc	떋
gos	떌
goj	떍
gon	떎
gor	떏
gop	떐
got	떑
goi	떒
gwo	떓
goo	떔
goa	떕
goh	떖
gob	떗
gom	떘
goq	떙
gou	떚
god	떛
goz	떜
goe	떝
gox	떞
gow	떟
gj	떠
gjy	떡
gjf	떢
gjv	떣
gjl	떤
gjk	떥
gjg	떦
gjc	떧
gjs	떨
gjj	떩
gjn	떪
gjr	떫
gjp	떬
gjt	떭
gji	떮
gwj	떯
gjo	떰
gja	떱
gjh	떲
gjb	떳
gjm	떴
gjq	떵
gju	떶
gjd	떷
gjz	떸
gje	떹
gjx	떺
gjw	떻
gp	떼
gpy	떽
gpf	떾
gpv	떿
gpl	뗀
gpk	뗁
gpg	뗂
gpc	뗃
gps	뗄
gpj	뗅
gpn	뗆
gpr	뗇
gpp	뗈
gpt	뗉
gpi	뗊
gwp	뗋
gpo	뗌
gpa	뗍
gph	뗎
gpb	뗏
gpm	뗐
gpq	뗑
gpu	뗒
gpd	뗓
gpz	뗔
gpe	뗕
gpx	뗖
gpw	뗗
gg	뗘
ggy	뗙
ggf	뗚
ggv	뗛
ggl	뗜
ggk	뗝
ggg	뗞
ggc	뗟
ggs	뗠
ggj	뗡
ggn	뗢
ggr	뗣
ggp	뗤
ggt	뗥
ggi	뗦
gwg	뗧
ggo	뗨
gga	뗩
ggh	뗪
ggb	뗫
ggm	뗬
ggq	뗭
ggu	뗮
ggd	뗯
ggz	뗰
gge	뗱
ggx	뗲
ggw	뗳
gq	뗴
gqy	뗵
gqf	뗶
gqv	뗷
gql	뗸
gqk	뗹
gqg	뗺
gqc	뗻
gqs	뗼
gqj	뗽
gqn	뗾
gqr	뗿
gqp	똀
gqt	똁
gqi	똂
gwq	똃
gqo	똄
gqa	똅
gqh	똆
gqb	똇
gqm	똈
gqq	똉
gqu	똊
gqd	똋
gqz	똌
gqe	똍
gqx	똎
gqw	똏
gn	또
gny	똑
gnf	똒
gnv	똓
gnl	똔
gnk	똕
gng	똖
gnc	똗
gns	똘
gnj	똙
gnn	똚
gnr	똛
gnp	똜
gnt	똝
gni	똞
gwn	똟
gno	똠
gna	똡
gnh	똢
gnb	똣
gnm	똤
gnq	똥
gnu	똦
gnd	똧
gnz	똨
gne	똩
gnx	똪
gnw	똫
ge	똬
gey	똭
gef	똮
gev	똯
gel	똰
gek	똱
geg	똲
gec	똳
ges	똴
gej	똵
gen	똶
ger	똷
gep	똸
get	똹
gei	똺
gwe	똻
geo	똼
gea	똽
geh	똾
geb	똿
gem	뙀
geq	뙁
geu	뙂
ged	뙃
gez	뙄
gee	뙅
gex	뙆
gew	뙇
gs	뙈
gsy	뙉
gsf	뙊
gsv	뙋
gsl	뙌
gsk	뙍
gsg	뙎
gsc	뙏
gss	뙐
gsj	뙑
gsn	뙒
gsr	뙓
gsp	뙔
gst	뙕
gsi	뙖
gws	뙗
gso	뙘
gsa	뙙
gsh	뙚
gsb	뙛
gsm	뙜
gsq	뙝
gsu	뙞
gsd	뙟
gsz	뙠
gse	뙡
gsx	뙢
gsw	뙣
gx	뙤
gxy	뙥
gxf	뙦
gxv	뙧
gxl	뙨
gxk	뙩
gxg	뙪
gxc	뙫
gxs	뙬
gxj	뙭
gxn	뙮
gxr	뙯
gxp	뙰
gxt	뙱
gxi	뙲
gwx	뙳
gxo	뙴
gxa	뙵
gxh	뙶
gxb	뙷
gxm	뙸
gxq	뙹
gxu	뙺
gxd	뙻
gxz	뙼
gxe	뙽
gxx	뙾
gxw	뙿
gm	뚀
gmy	뚁
gmf	뚂
gmv	뚃
gml	뚄
gmk	뚅
gmg	뚆
gmc	뚇
gms	뚈
gmj	뚉
gmn	뚊
gmr	뚋
gmp	뚌
gmt	뚍
gmi	뚎
gwm	뚏
gmo	뚐
gma	뚑
gmh	뚒
gmb	뚓
gmm	뚔
gmq	뚕
gmu	뚖
gmd	뚗
gmz	뚘
gme	뚙
gmx	뚚
gmw	뚛
gt	뚜
gty	뚝
gtf	뚞
gtv	뚟
gtl	뚠
gtk	뚡
gtg	뚢
gtc	뚣
gts	뚤
gtj	뚥
gtn	뚦
gtr	뚧
gtp	뚨
gtt	뚩
gti	뚪
gwt	뚫
gto	뚬
gta	뚭
gth	뚮
gtb	뚯
gtm	뚰
gtq	뚱
gtu	뚲
gtd	뚳
gtz	뚴
gte	뚵
gtx	뚶
gtw	뚷
ga	뚸
gay	뚹
gaf	뚺
gav	뚻
gal	뚼
gak	뚽
gag	뚾
gac	뚿
gas	뛀
gaj	뛁
gan	뛂
gar	뛃
gap	뛄
gat	뛅
gai	뛆
gwa	뛇
gao	뛈
gaa	뛉
gah	뛊
gab	뛋
gym	뛌
gaq	뛍
gau	뛎
gad	뛏
gaz	뛐
gae	뛑
gax	뛒
gaw	뛓
gz	뛔
gzy	뛕
gzf	뛖
gzv	뛗
gzl	뛘
gzk	뛙
gzg	뛚
gzc	뛛
gzs	뛜
gzj	뛝
gzn	뛞
gzr	뛟
gzp	뛠
gzt	뛡
gzi	뛢
gwz	뛣
gzo	뛤
gza	뛥
gzh	뛦
gzb	뛧
gzm	뛨
gzq	뛩
gzu	뛪
gzd	뛫
gzz	뛬
gze	뛭
gzx	뛮
gzw	뛯
gd	뛰
gdy	뛱
gdf	뛲
gdv	뛳
gdl	뛴
gdk	뛵
gdg	뛶
gdc	뛷
gds	뛸
gdj	뛹
gdn	뛺
gdr	뛻
gdp	뛼
gdt	뛽
gdi	뛾
gwd	뛿
gdo	뜀
gda	뜁
gdh	뜂
gdb	뜃
gdm	뜄
gdq	뜅
gdu	뜆
gdd	뜇
gdz	뜈
gde	뜉
gdx	뜊
gdw	뜋
gr	뜌
gry	뜍
grf	뜎
grv	뜏
grl	뜐
grk	뜑
grg	뜒
grc	뜓
grs	뜔
grj	뜕
grn	뜖
grr	뜗
grp	뜘
grt	뜙
gri	뜚
gwr	뜛
gro	뜜
gra	뜝
grh	뜞
grb	뜟
grm	뜠
grq	뜡
gru	뜢
grd	뜣
grz	뜤
gre	뜥
grx	뜦
grw	뜧
gv	뜨
gvy	뜩
gvf	뜪
gvv	뜫
gvl	뜬
gvk	뜭
gvg	뜮
gvc	뜯
gvs	뜰
gvj	뜱
gvn	뜲
gvr	뜳
gvp	뜴
gvt	뜵
gvi	뜶
gwv	뜷
gvo	뜸
gva	뜹
gvh	뜺
gvb	뜻
gvm	뜼
gvq	뜽
gvu	뜾
gvd	뜿
gvz	띀
gve	띁
gvx	띂
gvw	띃
gl	띄
gly	띅
glf	띆
glv	띇
gll	띈
glk	띉
glg	띊
glc	띋
gls	띌
glj	띍
gln	띎
glr	띏
glp	띐
glt	띑
gli	띒
gwl	띓
glo	띔
gla	띕
glh	띖
glb	띗
glm	띘
glq	띙
glu	띚
gld	띛
glz	띜
gle	띝
glx	띞
glw	띟
gi	띠
giy	띡
gif	띢
giv	띣
gil	띤
gik	띥
gig	띦
gic	띧
gis	띨
gij	띩
gin	띪
gir	띫
gip	띬
git	띭
gii	띮
gwi	띯
gio	띰
gia	띱
gih	띲
gib	띳
gim	띴
giq	띵
giu	띶
gid	띷
giz	띸
gie	띹
gix	띺
giw	띻
#s6
skf	띾
skv	띿
skk	랁
skg	랂
skj	랅
skn	랆
skr	랇
skp	랈
skt	랉
ski	랊
swk	랋
skh	랎
skm	랐
shf	랚
shv	랛
shk	랝
shg	랞
shj	랡
shn	랢
shr	랣
shp	랤
sht	랥
shi	랦
swh	랧
shh	랪
shm	랬
sff	랶
sfv	랷
sfk	랹
sfg	랺
sfj	랽
sfn	랾
sfr	랿
sfp	럀
sft	럁
sfi	럂
swf	럃
sfh	럆
sfm	럈
so	럐
soy	럑
sof	럒
sov	럓
sol	럔
sok	럕
sog	럖
soc	럗
sos	럘
soj	럙
son	럚
sor	럛
sop	럜
sot	럝
soi	럞
swo	럟
soo	럠
soa	럡
soh	럢
sob	럣
som	럤
soq	럥
sou	럦
sod	럧
soz	럨
soe	럩
sox	럪
sow	럫
sjf	럮
sjv	럯
sjk	럱
sjg	럲
sjj	럵
sjn	럶
sjr	럷
sjp	럸
sjt	럹
sji	럺
swj	럻
sjh	럾
sjm	렀
spf	렊
spv	렋
spk	렍
spg	렎
spj	렑
spn	렒
spr	렓
spp	렔
spt	렕
spi	렖
swp	렗
sph	렚
spm	렜
sgf	렦
sgv	렧
sgk	렩
sgg	렪
sgj	렭
sgn	렮
sgr	렯
sgp	렰
sgt	렱
sgi	렲
swg	렳
sgh	렶
sgm	렸
sq	례
sqy	롁
sqf	롂
sqv	롃
sql	롄
sqk	롅
sqg	롆
sqc	롇
sqs	롈
sqj	롉
sqn	롊
sqr	롋
sqp	롌
sqt	롍
sqi	롎
swq	롏
sqo	롐
sqa	롑
sqh	롒
sqb	롓
sqm	롔
sqq	롕
squ	롖
sqd	롗
sqz	롘
sqe	롙
sqx	롚
sqw	롛
snf	롞
snv	롟
snk	롡
sng	롢
snj	롥
snn	롦
snr	롧
snp	롨
snt	롩
sni	롪
swn	롫
snh	롮
snm	롰
se	롸
sey	롹
sef	롺
sev	롻
sel	롼
sek	롽
seg	롾
sec	롿
ses	뢀
sej	뢁
sen	뢂
ser	뢃
sep	뢄
set	뢅
sei	뢆
swe	뢇
seo	뢈
sea	뢉
seh	뢊
seb	뢋
sem	뢌
seq	뢍
seu	뢎
sed	뢏
sez	뢐
see	뢑
sex	뢒
sew	뢓
ss	뢔
ssy	뢕
ssf	뢖
ssv	뢗
ssl	뢘
ssk	뢙
ssg	뢚
ssc	뢛
sss	뢜
ssj	뢝
ssn	뢞
ssr	뢟
ssp	뢠
sst	뢡
ssi	뢢
sws	뢣
sso	뢤
ssa	뢥
ssh	뢦
ssb	뢧
ssm	뢨
ssq	뢩
ssu	뢪
ssd	뢫
ssz	뢬
sse	뢭
ssx	뢮
ssw	뢯
sx	뢰
sxy	뢱
sxf	뢲
sxv	뢳
sxl	뢴
sxk	뢵
sxg	뢶
sxc	뢷
sxs	뢸
sxj	뢹
sxn	뢺
sxr	뢻
sxp	뢼
sxt	뢽
sxi	뢾
swx	뢿
sxo	룀
sxa	룁
sxh	룂
sxb	룃
sxm	룄
sxq	룅
sxu	룆
sxd	룇
sxz	룈
sxe	룉
sxx	룊
sxw	룋
smf	룎
smv	룏
smk	룑
smg	룒
smj	룕
smn	룖
smr	룗
smp	룘
smt	룙
smi	룚
swm	룛
smh	룞
smm	룠
stf	룪
stv	룫
stk	룭
stg	룮
stj	룱
stn	룲
str	룳
stp	룴
stt	룵
sti	룶
swt	룷
sth	룺
stm	룼
sa	뤄
say	뤅
saf	뤆
sav	뤇
sal	뤈
sak	뤉
sag	뤊
sac	뤋
sas	뤌
saj	뤍
san	뤎
sar	뤏
sap	뤐
sat	뤑
sai	뤒
swa	뤓
sao	뤔
saa	뤕
sah	뤖
sab	뤗
sam	뤘
saq	뤙
sau	뤚
sad	뤛
saz	뤜
sae	뤝
sax	뤞
saw	뤟
sz	뤠
szy	뤡
szf	뤢
szv	뤣
szl	뤤
szk	뤥
szg	뤦
szc	뤧
szs	뤨
szj	뤩
szn	뤪
szr	뤫
szp	뤬
szt	뤭
szi	뤮
swz	뤯
szo	뤰
sza	뤱
szh	뤲
szb	뤳
szm	뤴
szq	뤵
szu	뤶
szd	뤷
szz	뤸
sze	뤹
szx	뤺
szw	뤻
sd	뤼
sdy	뤽
sdf	뤾
sdv	뤿
sdl	륀
sdk	륁
sdg	륂
sdc	륃
sds	륄
sdj	륅
sdn	륆
sdr	륇
sdp	륈
sdt	륉
sdi	륊
swd	륋
sdo	륌
sda	륍
sdh	륎
sdb	륏
sdm	륐
sdq	륑
sdu	륒
sdd	륓
sdz	륔
sde	륕
sdx	륖
sdw	륗
srf	륚
srv	륛
srk	륝
srg	륞
srj	륡
srn	륢
srr	륣
srp	륤
srt	륥
sri	륦
swr	륧
srh	륪
srm	륬
svf	륶
svv	륷
svk	륹
svg	륺
svj	륽
svn	륾
svr	륿
svp	릀
svt	릁
svi	릂
swv	릃
svh	릆
svm	릈
sl	릐
sly	릑
slf	릒
slv	릓
sll	릔
slk	릕
slg	릖
slc	릗
sls	릘
slj	릙
sln	릚
slr	릛
slp	릜
slt	릝
sli	릞
swl	릟
slo	릠
sla	릡
slh	릢
slb	릣
slm	릤
slq	릥
slu	릦
sld	릧
slz	릨
sle	릩
slx	릪
slw	릫
sif	릮
siv	릯
sik	릱
sig	릲
sij	릵
sin	릶
sir	릷
sip	릸
sit	릹
sii	릺
swi	릻
sih	릾
sim	맀
#s7
okf	맊
okv	맋
okk	맍
okg	많
okj	맑
okn	맒
okr	맓
okp	맔
okt	맕
oki	맖
owk	맗
okh	맚
okm	맜
ohf	맦
ohv	맧
ohk	맩
ohg	맪
ohj	맭
ohn	맮
ohr	맯
ohp	맰
oht	맱
ohi	맲
owh	맳
ohh	맶
ohm	맸
off	먂
ofv	먃
ofk	먅
ofg	먆
ofj	먉
ofn	먊
ofr	먋
ofp	먌
oft	먍
ofi	먎
owf	먏
ofh	먒
ofm	먔
oo	먜
ooy	먝
oof	먞
oov	먟
ool	먠
ook	먡
oog	먢
ooc	먣
oos	먤
ooj	먥
oon	먦
oor	먧
oop	먨
oot	먩
ooi	먪
owo	먫
ooo	먬
ooa	먭
ooh	먮
oob	먯
oom	먰
ooq	먱
oou	먲
ood	먳
ooz	먴
ooe	먵
oox	먶
oow	먷
ojf	먺
ojv	먻
ojk	먽
ojg	먾
ojj	멁
ojn	멂
ojr	멃
ojp	멄
ojt	멅
oji	멆
owj	멇
ojh	멊
ojm	멌
opf	멖
opv	멗
opk	멙
opg	멚
opj	멝
opn	멞
opr	멟
opp	멠
opt	멡
opi	멢
owp	멣
oph	멦
opm	멨
ogf	멲
ogv	멳
ogk	멵
ogg	멶
ogj	멹
ogn	멺
ogr	멻
ogp	멼
ogt	멽
ogi	멾
owg	멿
ogh	몂
ogm	몄
oq	몌
oqy	몍
oqf	몎
oqv	몏
oql	몐
oqk	몑
oqg	몒
oqc	몓
oqs	몔
oqj	몕
oqn	몖
oqr	몗
oqp	몘
oqt	몙
oqi	몚
owq	몛
oqo	몜
oqa	몝
oqh	몞
oqb	몟
oqm	몠
oqq	몡
oqu	몢
oqd	몣
oqz	몤
oqe	몥
oqx	몦
oqw	몧
onf	몪
onv	몫
onk	몭
ong	몮
onj	몱
onn	몲
onr	몳
onp	몴
ont	몵
oni	몶
own	몷
onh	몺
onm	몼
oe	뫄
oey	뫅
oef	뫆
oev	뫇
oel	뫈
oek	뫉
oeg	뫊
oec	뫋
oes	뫌
oej	뫍
oen	뫎
oer	뫏
oep	뫐
oet	뫑
oei	뫒
owe	뫓
oeo	뫔
oea	뫕
oeh	뫖
oeb	뫗
oem	뫘
oeq	뫙
oeu	뫚
oed	뫛
oez	뫜
oee	뫝
oex	뫞
oew	뫟
os	뫠
osy	뫡
osf	뫢
osv	뫣
osl	뫤
osk	뫥
osg	뫦
osc	뫧
oss	뫨
osj	뫩
osn	뫪
osr	뫫
osp	뫬
ost	뫭
osi	뫮
ows	뫯
oso	뫰
osa	뫱
osh	뫲
osb	뫳
osm	뫴
osq	뫵
osu	뫶
osd	뫷
osz	뫸
ose	뫹
osx	뫺
osw	뫻
od	뫼
ody	뫽
odf	뫾
odv	뫿
odl	묀
odk	묁
odg	묂
odc	묃
ods	묄
odj	묅
odn	묆
odr	묇
odp	묈
odt	묉
odi	묊
owd	묋
odo	묌
oda	묍
odh	묎
odb	묏
odm	묐
odq	묑
odu	묒
odd	묓
odz	묔
ode	묕
odx	묖
odw	묗
omf	묚
omv	묛
omk	묝
omg	묞
omj	묡
omn	묢
omr	묣
omp	묤
omt	묥
omi	묦
owm	묧
omh	묪
omm	묬
otf	묶
otv	묷
otk	묹
otg	묺
otj	묽
otn	묾
otr	묿
otp	뭀
ott	뭁
oti	뭂
owt	뭃
oth	뭆
otm	뭈
oa	뭐
oay	뭑
oaf	뭒
oav	뭓
oal	뭔
oak	뭕
oag	뭖
oac	뭗
oas	뭘
oaj	뭙
oan	뭚
oar	뭛
oap	뭜
oat	뭝
oai	뭞
owa	뭟
oao	뭠
oaa	뭡
oah	뭢
oab	뭣
oam	뭤
oaq	뭥
oau	뭦
oad	뭧
oaz	뭨
oae	뭩
oax	뭪
oaw	뭫
oz	뭬
ozy	뭭
ozf	뭮
ozv	뭯
ozl	뭰
ozk	뭱
ozg	뭲
ozc	뭳
ozs	뭴
ozj	뭵
ozn	뭶
ozr	뭷
ozp	뭸
ozt	뭹
ozi	뭺
owz	뭻
ozo	뭼
oza	뭽
ozh	뭾
ozb	뭿
ozm	뮀
ozq	뮁
ozu	뮂
ozd	뮃
ozz	뮄
oze	뮅
ozx	뮆
ozw	뮇
od	뮈
ody	뮉
odf	뮊
odv	뮋
odl	뮌
odk	뮍
odg	뮎
odc	뮏
ods	뮐
odj	뮑
odn	뮒
odr	뮓
odp	뮔
odt	뮕
odi	뮖
owd	뮗
odo	뮘
oda	뮙
odh	뮚
odb	뮛
odm	뮜
odq	뮝
odu	뮞
odd	뮟
odz	뮠
ode	뮡
odx	뮢
odw	뮣
orf	뮦
orv	뮧
ork	뮩
org	뮪
orj	뮭
orn	뮮
orr	뮯
orp	뮰
ort	뮱
ori	뮲
owr	뮳
orh	뮶
orm	뮸
ovf	믂
ovv	믃
ovk	믅
ovg	믆
ovj	믉
ovn	믊
ovr	믋
ovp	믌
ovt	믍
ovi	믎
owv	믏
ovh	믒
ovm	믔
ol	믜
oly	믝
olf	믞
olv	믟
oll	믠
olk	믡
olg	믢
olc	믣
ols	믤
olj	믥
oln	믦
olr	믧
olp	믨
olt	믩
oli	믪
owl	믫
olo	믬
ola	믭
olh	믮
olb	믯
olm	믰
olq	믱
olu	믲
old	믳
olz	믴
ole	믵
olx	믶
olw	믷
oif	믺
oiv	믻
oik	믽
oig	믾
oij	밁
oin	밂
oir	밃
oip	밄
oit	밅
oii	밆
owi	밇
oih	밊
oim	밌
#s8
akf	밖
akv	밗
akk	밙
akg	밚
akj	밝
akn	밞
akr	밟
akp	밠
akt	밡
aki	밢
awk	밣
akh	밦
akm	밨
ahf	밲
ahv	밳
ahk	밵
ahg	밶
ahj	밹
ahn	밺
ahr	밻
ahp	밼
aht	밽
ahi	밾
awh	밿
ahh	뱂
ahm	뱄
aff	뱎
afv	뱏
afk	뱑
afg	뱒
afj	뱕
afn	뱖
afr	뱗
afp	뱘
aft	뱙
afi	뱚
awf	뱛
afh	뱞
afm	뱠
ao	뱨
aoy	뱩
aof	뱪
aov	뱫
aol	뱬
aok	뱭
aog	뱮
aoc	뱯
aos	뱰
aoj	뱱
aon	뱲
aor	뱳
aop	뱴
aot	뱵
aoi	뱶
awo	뱷
aoo	뱸
aoa	뱹
aoh	뱺
aob	뱻
aom	뱼
aoq	뱽
aou	뱾
aod	뱿
aoz	벀
aoe	벁
aox	벂
aow	벃
ajf	벆
ajv	벇
ajk	벉
ajg	벊
ajj	벍
ajn	벎
ajr	벏
ajp	벐
ajt	벑
aji	벒
awj	벓
ajh	벖
ajm	벘
apf	벢
apv	벣
apk	벥
apg	벦
apj	벩
apn	벪
apr	벫
app	벬
apt	벭
api	벮
awp	벯
aph	벲
apm	벴
agf	벾
agv	벿
agk	볁
agg	볂
agj	볅
agn	볆
agr	볇
agp	볈
agt	볉
agi	볊
awg	볋
agh	볎
agm	볐
aq	볘
aqy	볙
aqf	볚
aqv	볛
aql	볜
aqk	볝
aqg	볞
aqc	볟
aqs	볠
aqj	볡
aqn	볢
aqr	볣
aqp	볤
aqt	볥
aqi	볦
awq	볧
aqo	볨
aqa	볩
aqh	볪
aqb	볫
aqm	볬
aqq	볭
aqu	볮
aqd	볯
aqz	볰
aqe	볱
aqx	볲
aqw	볳
anf	볶
anv	볷
ank	볹
ang	볺
anj	볽
ann	볾
anr	볿
anp	봀
ant	봁
ani	봂
awn	봃
anh	봆
anm	봈
ae	봐
aey	봑
aef	봒
aev	봓
ael	봔
aek	봕
aeg	봖
aec	봗
aes	봘
aej	봙
aen	봚
aer	봛
aep	봜
aet	봝
aei	봞
awe	봟
aeo	봠
aea	봡
aeh	봢
aeb	봣
aem	봤
aeq	봥
aeu	봦
aed	봧
aez	봨
aee	봩
aex	봪
aew	봫
as	봬
asy	봭
asf	봮
asv	봯
asl	봰
ask	봱
asg	봲
asc	봳
ass	봴
asj	봵
asn	봶
asr	봷
asp	봸
ast	봹
asi	봺
aws	봻
aso	봼
asa	봽
ash	봾
asb	봿
asm	뵀
asq	뵁
asu	뵂
asd	뵃
asz	뵄
ase	뵅
asx	뵆
asw	뵇
ax	뵈
axy	뵉
axf	뵊
axv	뵋
axl	뵌
axk	뵍
axg	뵎
axc	뵏
axs	뵐
axj	뵑
axn	뵒
axr	뵓
axp	뵔
axt	뵕
axi	뵖
awx	뵗
axo	뵘
axa	뵙
axh	뵚
axb	뵛
axm	뵜
axq	뵝
axu	뵞
axd	뵟
axz	뵠
axe	뵡
axx	뵢
axw	뵣
amf	뵦
amv	뵧
amk	뵩
amg	뵪
amj	뵭
amn	뵮
amr	뵯
amp	뵰
amt	뵱
ami	뵲
awm	뵳
amh	뵶
amm	뵸
atf	붂
atv	붃
atk	붅
atg	붆
atj	붉
atn	붊
atr	붋
atp	붌
att	붍
ati	붎
awt	붏
ath	붒
atm	붔
aa	붜
aay	붝
aaf	붞
aav	붟
aal	붠
aak	붡
aag	붢
aac	붣
aas	붤
aaj	붥
aan	붦
aar	붧
aap	붨
aat	붩
aai	붪
awa	붫
aao	붬
aaa	붭
aah	붮
aab	붯
aam	붰
aaq	붱
aau	붲
aad	붳
aaz	붴
aae	붵
aax	붶
aaw	붷
az	붸
azy	붹
azf	붺
azv	붻
azl	붼
azk	붽
azg	붾
azc	붿
azs	뷀
azj	뷁
azn	뷂
azr	뷃
azp	뷄
azt	뷅
azi	뷆
awz	뷇
azo	뷈
aza	뷉
azh	뷊
azb	뷋
azm	뷌
azq	뷍
azu	뷎
azd	뷏
azz	뷐
aze	뷑
azx	뷒
azw	뷓
ad	뷔
ady	뷕
adf	뷖
adv	뷗
adl	뷘
adk	뷙
adg	뷚
adc	뷛
ads	뷜
adj	뷝
adn	뷞
adr	뷟
adp	뷠
adt	뷡
adi	뷢
awd	뷣
ado	뷤
ada	뷥
adh	뷦
adb	뷧
adm	뷨
adq	뷩
adu	뷪
add	뷫
adz	뷬
ade	뷭
adx	뷮
adw	뷯
arf	뷲
arv	뷳
ark	뷵
arg	뷶
arj	뷹
arn	뷺
arr	뷻
arp	뷼
art	뷽
ari	뷾
awr	뷿
arh	븂
arm	븄
avf	븎
avv	븏
avk	븑
avg	븒
avj	븕
avn	븖
avr	븗
avp	븘
avt	븙
avi	븚
awv	븛
avh	븞
avm	븠
al	븨
aly	븩
alf	븪
alv	븫
all	븬
alk	븭
alg	븮
alc	븯
als	븰
alj	븱
aln	븲
alr	븳
alp	븴
alt	븵
ali	븶
awl	븷
alo	븸
ala	븹
alh	븺
alb	븻
alm	븼
alq	븽
alu	븾
ald	븿
alz	빀
ale	빁
alx	빂
alw	빃
aif	빆
aiv	빇
aik	빉
aig	빊
aij	빍
ain	빎
air	빏
aip	빐
ait	빑
aii	빒
awi	빓
aih	빖
aim	빘
#s9
rk	빠
rky	빡
rkf	빢
rkv	빣
rkl	빤
rkk	빥
rkg	빦
rkc	빧
rks	빨
rkj	빩
rkn	빪
rkr	빫
rkp	빬
rkt	빭
rki	빮
rwk	빯
rko	빰
rka	빱
rkh	빲
rkb	빳
rkm	빴
rkq	빵
rku	빶
rkd	빷
rkz	빸
rke	빹
rkx	빺
rkw	빻
rh	빼
rhy	빽
rhf	빾
rhv	빿
rhl	뺀
rhk	뺁
rhg	뺂
rhc	뺃
rhs	뺄
rhj	뺅
rhn	뺆
rhr	뺇
rhp	뺈
rht	뺉
rhi	뺊
rwh	뺋
rho	뺌
rha	뺍
rhh	뺎
rhb	뺏
rhm	뺐
rhq	뺑
rhu	뺒
rhd	뺓
rhz	뺔
rhe	뺕
rhx	뺖
rhw	뺗
rf	뺘
rfy	뺙
rff	뺚
rfv	뺛
rfl	뺜
rfk	뺝
rfg	뺞
rfc	뺟
rfs	뺠
rfj	뺡
rfn	뺢
rfr	뺣
rfp	뺤
rft	뺥
rfi	뺦
rwf	뺧
rfo	뺨
rfa	뺩
rfh	뺪
rfb	뺫
rfm	뺬
rfq	뺭
rfu	뺮
rfd	뺯
rfz	뺰
rfe	뺱
rfx	뺲
rfw	뺳
ro	뺴
roy	뺵
rof	뺶
rov	뺷
rol	뺸
rok	뺹
rog	뺺
roc	뺻
ros	뺼
roj	뺽
ron	뺾
ror	뺿
rop	뻀
rot	뻁
roi	뻂
rwo	뻃
roo	뻄
roa	뻅
roh	뻆
rob	뻇
rom	뻈
roq	뻉
rou	뻊
rod	뻋
roz	뻌
roe	뻍
rox	뻎
row	뻏
rj	뻐
rjy	뻑
rjf	뻒
rjv	뻓
rjl	뻔
rjk	뻕
rjg	뻖
rjc	뻗
rjs	뻘
rjj	뻙
rjn	뻚
rjr	뻛
rjp	뻜
rjt	뻝
rji	뻞
rwj	뻟
rjo	뻠
rja	뻡
rjh	뻢
rjb	뻣
rjm	뻤
rjq	뻥
rju	뻦
rjd	뻧
rjz	뻨
rje	뻩
rjx	뻪
rjw	뻫
rp	뻬
rpy	뻭
rpf	뻮
rpv	뻯
rpl	뻰
rpk	뻱
rpg	뻲
rpc	뻳
rps	뻴
rpj	뻵
rpn	뻶
rpr	뻷
rpp	뻸
rpt	뻹
rpi	뻺
rwp	뻻
rpo	뻼
rpa	뻽
rph	뻾
rpb	뻿
rpm	뼀
rpq	뼁
rpu	뼂
rpd	뼃
rpz	뼄
rpe	뼅
rpx	뼆
rpw	뼇
rg	뼈
rgy	뼉
rgf	뼊
rgv	뼋
rgl	뼌
rgk	뼍
rgg	뼎
rgc	뼏
rgs	뼐
rgj	뼑
rgn	뼒
rgr	뼓
rgp	뼔
rgt	뼕
rgi	뼖
rwg	뼗
rgo	뼘
rga	뼙
rgh	뼚
rgb	뼛
rgm	뼜
rgq	뼝
rgu	뼞
rgd	뼟
rgz	뼠
rge	뼡
rgx	뼢
rgw	뼣
rq	뼤
rqy	뼥
rqf	뼦
rqv	뼧
rql	뼨
rqk	뼩
rqg	뼪
rqc	뼫
rqs	뼬
rqj	뼭
rqn	뼮
rqr	뼯
rqp	뼰
rqt	뼱
rqi	뼲
rwq	뼳
rqo	뼴
rqa	뼵
rqh	뼶
rqb	뼷
rqm	뼸
rqq	뼹
rqu	뼺
rqd	뼻
rqz	뼼
rqe	뼽
rqx	뼾
rqw	뼿
rn	뽀
rny	뽁
rnf	뽂
rnv	뽃
rnl	뽄
rnk	뽅
rng	뽆
rnc	뽇
rns	뽈
rnj	뽉
rnn	뽊
rnr	뽋
rnp	뽌
rnt	뽍
rni	뽎
rwn	뽏
rno	뽐
rna	뽑
rnh	뽒
rnb	뽓
rnm	뽔
rnq	뽕
rnu	뽖
rnd	뽗
rnz	뽘
rne	뽙
rnx	뽚
rnw	뽛
re	뽜
rey	뽝
ref	뽞
rev	뽟
rel	뽠
rek	뽡
reg	뽢
rec	뽣
res	뽤
rej	뽥
ren	뽦
rer	뽧
rep	뽨
ret	뽩
rei	뽪
rwe	뽫
reo	뽬
rea	뽭
reh	뽮
reb	뽯
rem	뽰
req	뽱
reu	뽲
red	뽳
rez	뽴
ree	뽵
rex	뽶
rew	뽷
rs	뽸
rsy	뽹
rsf	뽺
rsv	뽻
rsl	뽼
rsk	뽽
rsg	뽾
rsc	뽿
rss	뾀
rsj	뾁
rsn	뾂
rsr	뾃
rsp	뾄
rst	뾅
rsi	뾆
rws	뾇
rso	뾈
rsa	뾉
rsh	뾊
rsb	뾋
rsm	뾌
rsq	뾍
rsu	뾎
rsd	뾏
rsz	뾐
rse	뾑
rsx	뾒
rsw	뾓
rx	뾔
rxy	뾕
rxf	뾖
rxv	뾗
rxl	뾘
rxk	뾙
rxg	뾚
rxc	뾛
rxs	뾜
rxj	뾝
rxn	뾞
rxr	뾟
rxp	뾠
rxt	뾡
rxi	뾢
rwx	뾣
rxo	뾤
rxa	뾥
rxh	뾦
rxb	뾧
rxm	뾨
rxq	뾩
rxu	뾪
rxd	뾫
rxz	뾬
rxe	뾭
rxx	뾮
rxw	뾯
rm	뾰
rmy	뾱
rmf	뾲
rmv	뾳
rml	뾴
rmk	뾵
rmg	뾶
rmc	뾷
rms	뾸
rmj	뾹
rmn	뾺
rmr	뾻
rmp	뾼
rmt	뾽
rmi	뾾
rwm	뾿
rmo	뿀
rma	뿁
rmh	뿂
rmb	뿃
rmm	뿄
rmq	뿅
rmu	뿆
rmd	뿇
rmz	뿈
rme	뿉
rmx	뿊
rmw	뿋
rt	뿌
rty	뿍
rtf	뿎
rtv	뿏
rtl	뿐
rtk	뿑
rtg	뿒
rtc	뿓
rts	뿔
rtj	뿕
rtn	뿖
rtr	뿗
rtp	뿘
rtt	뿙
rti	뿚
rwt	뿛
rto	뿜
rta	뿝
rth	뿞
rtb	뿟
rtm	뿠
rtq	뿡
rtu	뿢
rtd	뿣
rtz	뿤
rte	뿥
rtx	뿦
rtw	뿧
ra	뿨
ray	뿩
raf	뿪
rav	뿫
ral	뿬
rak	뿭
rag	뿮
rac	뿯
ras	뿰
raj	뿱
ran	뿲
rar	뿳
rap	뿴
rat	뿵
rai	뿶
rwa	뿷
rao	뿸
raa	뿹
rah	뿺
rab	뿻
ram	뿼
raq	뿽
rau	뿾
rad	뿿
raz	쀀
rae	쀁
rax	쀂
raw	쀃
rz	쀄
rzy	쀅
rzf	쀆
rzv	쀇
rzl	쀈
rzk	쀉
rzg	쀊
rzc	쀋
rzs	쀌
rzj	쀍
rzn	쀎
rzr	쀏
rzp	쀐
rzt	쀑
rzi	쀒
rwz	쀓
rzo	쀔
rza	쀕
rzh	쀖
rzb	쀗
rzm	쀘
rzq	쀙
rzu	쀚
rzd	쀛
rzz	쀜
rze	쀝
rzx	쀞
rzw	쀟
rd	쀠
rdy	쀡
rdf	쀢
rdv	쀣
rdl	쀤
rdk	쀥
rdg	쀦
rdc	쀧
rds	쀨
rdj	쀩
rdn	쀪
rdr	쀫
rdp	쀬
rdt	쀭
rdi	쀮
rwd	쀯
rdo	쀰
rda	쀱
rdh	쀲
rdb	쀳
rdm	쀴
rdq	쀵
rdu	쀶
rdd	쀷
rdz	쀸
rde	쀹
rdx	쀺
rdw	쀻
rr	쀼
rry	쀽
rrf	쀾
rrv	쀿
rrl	쁀
rrk	쁁
rrg	쁂
rrc	쁃
rrs	쁄
rrj	쁅
rrn	쁆
rrr	쁇
rrp	쁈
rrt	쁉
rri	쁊
rwr	쁋
rro	쁌
rra	쁍
rrh	쁎
rrb	쁏
rrm	쁐
rrq	쁑
rru	쁒
rrd	쁓
rrz	쁔
rre	쁕
rrx	쁖
rrw	쁗
rv	쁘
rvy	쁙
rvf	쁚
rvv	쁛
rvl	쁜
rvk	쁝
rvg	쁞
rvc	쁟
rvs	쁠
rvj	쁡
rvn	쁢
rvr	쁣
rvp	쁤
rvt	쁥
rvi	쁦
rwv	쁧
rvo	쁨
rva	쁩
rvh	쁪
rvb	쁫
rvm	쁬
rvq	쁭
rvu	쁮
rvd	쁯
rvz	쁰
rve	쁱
rvx	쁲
rvw	쁳
rl	쁴
rly	쁵
rlf	쁶
rlv	쁷
rll	쁸
rlk	쁹
rlg	쁺
rlc	쁻
rls	쁼
rlj	쁽
rln	쁾
rlr	쁿
rlp	삀
rlt	삁
rli	삂
rwl	삃
rlo	삄
rla	삅
rlh	삆
rlb	삇
rlm	삈
rlq	삉
rlu	삊
rld	삋
rlz	삌
rle	삍
rlx	삎
rlw	삏
ri	삐
riy	삑
rif	삒
riv	삓
ril	삔
rik	삕
rig	삖
ric	삗
ris	삘
rij	삙
rin	삚
rir	삛
rip	삜
rit	삝
rii	삞
rwi	삟
rio	삠
ria	삡
rih	삢
rib	삣
rim	삤
riq	삥
riu	삦
rid	삧
riz	삨
rie	삩
rix	삪
riw	삫
#s10
bkf	삮
bkv	삯
bkk	삱
bkg	삲
bkj	삵
bkn	삶
bkr	삷
bkp	삸
bkt	삹
bki	삺
bwk	삻
bkh	삾
bkm	샀
bhf	샊
bhv	샋
bhk	샍
bhg	샎
bhj	샑
bhn	샒
bhr	샓
bhp	샔
bht	샕
bhi	샖
bwh	샗
bhh	샚
bhm	샜
bff	샦
bfv	샧
bfk	샩
bfg	샪
bfj	샭
bfn	샮
bfr	샯
bfp	샰
bft	샱
bfi	샲
bwf	샳
bfh	샶
bfm	샸
bo	섀
boy	섁
bof	섂
bov	섃
bol	섄
bok	섅
bog	섆
boc	섇
bos	섈
boj	섉
bon	섊
bor	섋
bop	섌
bot	섍
boi	섎
bwo	섏
boo	섐
boa	섑
boh	섒
bob	섓
bom	섔
boq	섕
bou	섖
bod	섗
boz	섘
boe	섙
box	섚
bow	섛
bjf	섞
bjv	섟
bjk	섡
bjg	섢
bjj	섥
bjn	섦
bjr	섧
bjp	섨
bjt	섩
bji	섪
bwj	섫
bjh	섮
bjm	섰
bpf	섺
bpv	섻
bpk	섽
bpg	섾
bpj	셁
bpn	셂
bpr	셃
bpp	셄
bpt	셅
bpi	셆
bwp	셇
bph	셊
bpm	셌
bgf	셖
bgv	셗
bgk	셙
bgg	셚
bgj	셝
bgn	셞
bgr	셟
bgp	셠
bgt	셡
bgi	셢
bwg	셣
bgh	셦
bgm	셨
bq	셰
bqy	셱
bqf	셲
bqv	셳
bql	셴
bqk	셵
bqg	셶
bqc	셷
bqs	셸
bqj	셹
bqn	셺
bqr	셻
bqp	셼
bqt	셽
bqi	셾
bwq	셿
bqo	솀
bqa	솁
bqh	솂
bqb	솃
bqm	솄
bqq	솅
bqu	솆
bqd	솇
bqz	솈
bqe	솉
bqx	솊
bqw	솋
bnf	솎
bnv	솏
bnk	솑
bng	솒
bnj	솕
bnn	솖
bnr	솗
bnp	솘
bnt	솙
bni	솚
bwn	솛
bnh	솞
bnm	솠
be	솨
bey	솩
bef	솪
bev	솫
bel	솬
bek	솭
beg	솮
bec	솯
bes	솰
bej	솱
ben	솲
ber	솳
bep	솴
bet	솵
bei	솶
bwe	솷
beo	솸
bea	솹
beh	솺
beb	솻
bem	솼
beq	솽
beu	솾
bed	솿
bez	쇀
bee	쇁
bex	쇂
bew	쇃
bs	쇄
bsy	쇅
bsf	쇆
bsv	쇇
bsl	쇈
bsk	쇉
bsg	쇊
bsc	쇋
bss	쇌
bsj	쇍
bsn	쇎
bsr	쇏
bsp	쇐
bst	쇑
bsi	쇒
bws	쇓
bso	쇔
bsa	쇕
bsh	쇖
bsb	쇗
bsm	쇘
bsq	쇙
bsu	쇚
bsd	쇛
bsz	쇜
bse	쇝
bsx	쇞
bsw	쇟
bx	쇠
bxy	쇡
bxf	쇢
bxv	쇣
bxl	쇤
bxk	쇥
bxg	쇦
bxc	쇧
bxs	쇨
bxj	쇩
bxn	쇪
bxr	쇫
bxp	쇬
bxt	쇭
bxi	쇮
bwx	쇯
bxo	쇰
bxa	쇱
bxh	쇲
bxb	쇳
bxm	쇴
bxq	쇵
bxu	쇶
bxd	쇷
bxz	쇸
bxe	쇹
bxx	쇺
bxw	쇻
bmf	쇾
bmv	쇿
bmk	숁
bmg	숂
bmj	숅
bmn	숆
bmr	숇
bmp	숈
bmt	숉
bmi	숊
bwm	숋
bmh	숎
bmm	숐
btf	숚
btv	숛
btk	숝
btg	숞
btj	숡
btn	숢
btr	숣
btp	숤
btt	숥
bti	숦
bwt	숧
bth	숪
btm	숬
ba	숴
bay	숵
baf	숶
bav	숷
bal	숸
bak	숹
bag	숺
bac	숻
bas	숼
baj	숽
ban	숾
bar	숿
bap	쉀
bat	쉁
bai	쉂
bwa	쉃
bao	쉄
baa	쉅
bah	쉆
bab	쉇
bam	쉈
baq	쉉
bau	쉊
bad	쉋
baz	쉌
bae	쉍
bax	쉎
baw	쉏
bz	쉐
bzy	쉑
bzf	쉒
bzv	쉓
bzl	쉔
bzk	쉕
bzg	쉖
bzc	쉗
bzs	쉘
bzj	쉙
bzn	쉚
bzr	쉛
bzp	쉜
bzt	쉝
bzi	쉞
bwz	쉟
bzo	쉠
bza	쉡
bzh	쉢
bzb	쉣
bzm	쉤
bzq	쉥
bzu	쉦
bzd	쉧
bzz	쉨
bze	쉩
bzx	쉪
bzw	쉫
bd	쉬
bdy	쉭
bdf	쉮
bdv	쉯
bdl	쉰
bdk	쉱
bdg	쉲
bdc	쉳
bds	쉴
bdj	쉵
bdn	쉶
bdr	쉷
bdp	쉸
bdt	쉹
bdi	쉺
bwd	쉻
bdo	쉼
bda	쉽
bdh	쉾
bdb	쉿
bdm	슀
bdq	슁
bdu	슂
bdd	슃
bdz	슄
bde	슅
bdx	슆
bdw	슇
brf	슊
brv	슋
brk	슍
brg	슎
brj	슑
brn	슒
brr	슓
brp	슔
brt	슕
bri	슖
bwr	슗
brh	슚
brm	슜
bvf	슦
bvv	슧
bvk	슩
bvg	슪
bvj	슭
bvn	슮
bvr	슯
bvp	슰
bvt	슱
bvi	슲
bwv	슳
bvh	슶
bvm	슸
bl	싀
bly	싁
blf	싂
blv	싃
bll	싄
blk	싅
blg	싆
blc	싇
bls	싈
blj	싉
bln	싊
blr	싋
blp	싌
blt	싍
bli	싎
bwl	싏
blo	싐
bla	싑
blh	싒
blb	싓
blm	싔
blq	싕
blu	싖
bld	싗
blz	싘
ble	싙
blx	싚
blw	싛
bif	싞
biv	싟
bik	싡
big	싢
bij	싥
bin	싦
bir	싧
bip	싨
bit	싩
bii	싪
bwi	싫
bih	싮
bim	싰
#s11
mk	싸
mky	싹
mkf	싺
mkv	싻
mkl	싼
mkk	싽
mkg	싾
mkc	싿
mks	쌀
mkj	쌁
mkn	쌂
mkr	쌃
mkp	쌄
mkt	쌅
mki	쌆
mwk	쌇
mko	쌈
mka	쌉
mkh	쌊
mkb	쌋
mkm	쌌
mkq	쌍
mku	쌎
mkd	쌏
mkz	쌐
mke	쌑
mkx	쌒
mkw	쌓
mh	쌔
mhy	쌕
mhf	쌖
mhv	쌗
mhl	쌘
mhk	쌙
mhg	쌚
mhc	쌛
mhs	쌜
mhj	쌝
mhn	쌞
mhr	쌟
mhp	쌠
mht	쌡
mhi	쌢
mwh	쌣
mho	쌤
mha	쌥
mhh	쌦
mhb	쌧
mhm	쌨
mhq	쌩
mhu	쌪
mhd	쌫
mhz	쌬
mhe	쌭
mhx	쌮
mhw	쌯
mf	쌰
mfy	쌱
mff	쌲
mfv	쌳
mfl	쌴
mfk	쌵
mfg	쌶
mfc	쌷
mfs	쌸
mfj	쌹
mfn	쌺
mfr	쌻
mfp	쌼
mft	쌽
mfi	쌾
mwf	쌿
mfo	썀
mfa	썁
mfh	썂
mfb	썃
mfm	썄
mfq	썅
mfu	썆
mfd	썇
mfz	썈
mfe	썉
mfx	썊
mfw	썋
mo	썌
moy	썍
mof	썎
mov	썏
mol	썐
mok	썑
mog	썒
moc	썓
mos	썔
moj	썕
mon	썖
mor	썗
mop	썘
mot	썙
moi	썚
mwo	썛
moo	썜
moa	썝
moh	썞
mob	썟
mom	썠
moq	썡
mou	썢
mod	썣
moz	썤
moe	썥
mox	썦
mow	썧
mj	써
mjy	썩
mjf	썪
mjv	썫
mjl	썬
mjk	썭
mjg	썮
mjc	썯
mjs	썰
mjj	썱
mjn	썲
mjr	썳
mjp	썴
mjt	썵
mji	썶
mwj	썷
mjo	썸
mja	썹
mjh	썺
mjb	썻
mjm	썼
mjq	썽
mju	썾
mjd	썿
mjz	쎀
mje	쎁
mjx	쎂
mjw	쎃
mp	쎄
mpy	쎅
mpf	쎆
mpv	쎇
mpl	쎈
mpk	쎉
mpg	쎊
mpc	쎋
mps	쎌
mpj	쎍
mpn	쎎
mpr	쎏
mpp	쎐
mpt	쎑
mpi	쎒
mwp	쎓
mpo	쎔
mpa	쎕
mph	쎖
mpb	쎗
mpm	쎘
mpq	쎙
mpu	쎚
mpd	쎛
mpz	쎜
mpe	쎝
mpx	쎞
mpw	쎟
mg	쎠
mgy	쎡
mgf	쎢
mgv	쎣
mgl	쎤
mgk	쎥
mgg	쎦
mgc	쎧
mgs	쎨
mgj	쎩
mgn	쎪
mgr	쎫
mgp	쎬
mgt	쎭
mgi	쎮
mwg	쎯
mgo	쎰
mga	쎱
mgh	쎲
mgb	쎳
mgm	쎴
mgq	쎵
mgu	쎶
mgd	쎷
mgz	쎸
mge	쎹
mgx	쎺
mgw	쎻
mq	쎼
mqy	쎽
mqf	쎾
mqv	쎿
mql	쏀
mqk	쏁
mqg	쏂
mqc	쏃
mqs	쏄
mqj	쏅
mqn	쏆
mqr	쏇
mqp	쏈
mqt	쏉
mqi	쏊
mwq	쏋
mqo	쏌
mqa	쏍
mqh	쏎
mqb	쏏
mqm	쏐
mqq	쏑
mqu	쏒
mqd	쏓
mqz	쏔
mqe	쏕
mqx	쏖
mqw	쏗
mn	쏘
mny	쏙
mnf	쏚
mnv	쏛
mnl	쏜
mnk	쏝
mng	쏞
mnc	쏟
mns	쏠
mnj	쏡
mnn	쏢
mnr	쏣
mnp	쏤
mnt	쏥
mni	쏦
mwn	쏧
mno	쏨
mna	쏩
mnh	쏪
mnb	쏫
mnm	쏬
mnq	쏭
mnu	쏮
mnd	쏯
mnz	쏰
mne	쏱
mnx	쏲
mnw	쏳
me	쏴
mey	쏵
mef	쏶
mev	쏷
mel	쏸
mek	쏹
meg	쏺
mec	쏻
mes	쏼
mej	쏽
men	쏾
mer	쏿
mep	쐀
met	쐁
mei	쐂
mwe	쐃
meo	쐄
mea	쐅
meh	쐆
meb	쐇
mem	쐈
meq	쐉
meu	쐊
med	쐋
mez	쐌
mee	쐍
mex	쐎
mew	쐏
ms	쐐
msy	쐑
msf	쐒
msv	쐓
msl	쐔
msk	쐕
msg	쐖
msc	쐗
mss	쐘
msj	쐙
msn	쐚
msr	쐛
msp	쐜
mst	쐝
msi	쐞
mws	쐟
mso	쐠
msa	쐡
msh	쐢
msb	쐣
msm	쐤
msq	쐥
msu	쐦
msd	쐧
msz	쐨
mse	쐩
msx	쐪
msw	쐫
mx	쐬
mxy	쐭
mxf	쐮
mxv	쐯
mxl	쐰
mxk	쐱
mxg	쐲
mxc	쐳
mxs	쐴
mxj	쐵
mxn	쐶
mxr	쐷
mxp	쐸
mxt	쐹
mxi	쐺
mwx	쐻
mxo	쐼
mxa	쐽
mxh	쐾
mxb	쐿
mxm	쑀
mxq	쑁
mxu	쑂
mxd	쑃
mxz	쑄
mxe	쑅
mxx	쑆
mxw	쑇
mm	쑈
mmy	쑉
mmf	쑊
mmv	쑋
mml	쑌
mmk	쑍
mmg	쑎
mmc	쑏
mms	쑐
mmj	쑑
mmn	쑒
mmr	쑓
mmp	쑔
mmt	쑕
mmi	쑖
mwm	쑗
mmo	쑘
mma	쑙
mmh	쑚
mmb	쑛
mmm	쑜
mmq	쑝
mmu	쑞
mmd	쑟
mmz	쑠
mme	쑡
mmx	쑢
mmw	쑣
mt	쑤
mty	쑥
mtf	쑦
mtv	쑧
mtl	쑨
mtk	쑩
mtg	쑪
mtc	쑫
mts	쑬
mtj	쑭
mtn	쑮
mtr	쑯
mtp	쑰
mtt	쑱
mti	쑲
mwt	쑳
mto	쑴
mta	쑵
mth	쑶
mtb	쑷
mtm	쑸
mtq	쑹
mtu	쑺
mtd	쑻
mtz	쑼
mte	쑽
mtx	쑾
mtw	쑿
ma	쒀
may	쒁
maf	쒂
mav	쒃
mal	쒄
mak	쒅
mag	쒆
mac	쒇
mas	쒈
maj	쒉
man	쒊
mar	쒋
map	쒌
mat	쒍
mai	쒎
mwa	쒏
mao	쒐
maa	쒑
mah	쒒
mab	쒓
mam	쒔
maq	쒕
mau	쒖
mad	쒗
maz	쒘
mae	쒙
max	쒚
maw	쒛
mz	쒜
mzy	쒝
mzf	쒞
mzv	쒟
mzl	쒠
mzk	쒡
mzg	쒢
mzc	쒣
mzs	쒤
mzj	쒥
mzn	쒦
mzr	쒧
mzp	쒨
mzt	쒩
mzi	쒪
mwz	쒫
mzo	쒬
mza	쒭
mzh	쒮
mzb	쒯
mzm	쒰
mzq	쒱
mzu	쒲
mzd	쒳
mzz	쒴
mze	쒵
mzx	쒶
mzw	쒷
md	쒸
mdy	쒹
mdf	쒺
mdv	쒻
mdl	쒼
mdk	쒽
mdg	쒾
mdc	쒿
mds	쓀
mdj	쓁
mdn	쓂
mdr	쓃
mdp	쓄
mdt	쓅
mdi	쓆
mwd	쓇
mdo	쓈
mda	쓉
mdh	쓊
mdb	쓋
mdm	쓌
mdq	쓍
mdu	쓎
mdd	쓏
mdz	쓐
mde	쓑
mdx	쓒
mdw	쓓
mr	쓔
mry	쓕
mrf	쓖
mrv	쓗
mrl	쓘
mrk	쓙
mrg	쓚
mrc	쓛
mrs	쓜
mrj	쓝
mrn	쓞
mrr	쓟
mrp	쓠
mrt	쓡
mri	쓢
mwr	쓣
mro	쓤
mra	쓥
mrh	쓦
mrb	쓧
mrm	쓨
mrq	쓩
mru	쓪
mrd	쓫
mrz	쓬
mre	쓭
mrx	쓮
mrw	쓯
mv	쓰
mvy	쓱
mvf	쓲
mvv	쓳
mvl	쓴
mvk	쓵
mvg	쓶
mvc	쓷
mvs	쓸
mvj	쓹
mvn	쓺
mvr	쓻
mvp	쓼
mvt	쓽
mvi	쓾
mwv	쓿
mvo	씀
mva	씁
mvh	씂
mvb	씃
mvm	씄
mvq	씅
mvu	씆
mvd	씇
mvz	씈
mve	씉
mvx	씊
mvw	씋
ml	씌
mly	씍
mlf	씎
mlv	씏
mll	씐
mlk	씑
mlg	씒
mlc	씓
mls	씔
mlj	씕
mln	씖
mlr	씗
mlp	씘
mlt	씙
mli	씚
mwl	씛
mlo	씜
mla	씝
mlh	씞
mlb	씟
mlm	씠
mlq	씡
mlu	씢
mld	씣
mlz	씤
mle	씥
mlx	씦
mlw	씧
mi	씨
miy	씩
mif	씪
miv	씫
mil	씬
mik	씭
mig	씮
mic	씯
mis	씰
mij	씱
min	씲
mir	씳
mip	씴
mit	씵
mii	씶
mwi	씷
mio	씸
mia	씹
mih	씺
mib	씻
mim	씼
miq	씽
miu	씾
mid	씿
miz	앀
mie	앁
mix	앂
miw	앃
#s12
qkf	앆
qkv	앇
qkk	앉
qkg	않
qkj	앍
qkn	앎
qkr	앏
qkp	앐
qkt	앑
qki	앒
qwk	앓
qkh	앖
qkm	았
qhf	앢
qhv	앣
qhk	앥
qhg	앦
qhj	앩
qhn	앪
qhr	앫
qhp	앬
qht	앭
qhi	앮
qwh	앯
qhh	앲
qhm	앴
qff	앾
qfv	앿
qfk	얁
qfg	얂
qfj	얅
qfn	얆
qfr	얇
qfp	얈
qft	얉
qfi	얊
qwf	얋
qfh	얎
qfm	얐
qo	얘
qoy	얙
qof	얚
qov	얛
qol	얜
qok	얝
qog	얞
qoc	얟
qos	얠
qoj	얡
qon	얢
qor	얣
qop	얤
qot	얥
qoi	얦
qwo	얧
qoo	얨
qoa	얩
qoh	얪
qob	얫
qom	얬
qoq	얭
qou	얮
qod	얯
qoz	얰
qoe	얱
qox	얲
qow	얳
qjf	얶
qjv	얷
qjk	얹
qjg	얺
qjj	얽
qjn	얾
qjr	얿
qjp	엀
qjt	엁
qji	엂
qwj	엃
qjh	없
qjm	었
qpf	엒
qpv	엓
qpk	엕
qpg	엖
qpj	엙
qpn	엚
qpr	엛
qpp	엜
qpt	엝
qpi	엞
qwp	엟
qph	엢
qpm	엤
qgf	엮
qgv	엯
qgk	엱
qgg	엲
qgj	엵
qgn	엶
qgr	엷
qgp	엸
qgt	엹
qgi	엺
qwg	엻
qgh	엾
qgm	였
qq	예
qqy	옉
qqf	옊
qqv	옋
qql	옌
qqk	옍
qqg	옎
qqc	옏
qqs	옐
qqj	옑
qqn	옒
qqr	옓
qqp	옔
qqt	옕
qqi	옖
qwq	옗
qqo	옘
qqa	옙
qqh	옚
qqb	옛
qqm	옜
qqq	옝
qqu	옞
qqd	옟
qqz	옠
qqe	옡
qqx	옢
qqw	옣
qnf	옦
qnv	옧
qnk	옩
qng	옪
qnj	옭
qnn	옮
qnr	옯
qnp	옰
qnt	옱
qni	옲
qwn	옳
qnh	옶
qnm	옸
qe	와
qey	왁
qef	왂
qev	왃
qel	완
qek	왅
qeg	왆
qec	왇
qes	왈
qej	왉
qen	왊
qer	왋
qep	왌
qet	왍
qei	왎
qwe	왏
qeo	왐
qea	왑
qeh	왒
qeb	왓
qem	왔
qeq	왕
qeu	왖
qed	왗
qez	왘
qee	왙
qex	왚
qew	왛
qs	왜
qsy	왝
qsf	왞
qsv	왟
qsl	왠
qsk	왡
qsg	왢
qsc	왣
qss	왤
qsj	왥
qsn	왦
qsr	왧
qsp	왨
qst	왩
qsi	왪
qws	왫
qso	왬
qsa	왭
qsh	왮
qsb	왯
qsm	왰
qsq	왱
qsu	왲
qsd	왳
qsz	왴
qse	왵
qsx	왶
qsw	왷
qx	외
qxy	왹
qxf	왺
qxv	왻
qxl	왼
qxk	왽
qxg	왾
qxc	왿
qxs	욀
qxj	욁
qxn	욂
qxr	욃
qxp	욄
qxt	욅
qxi	욆
qwx	욇
qxo	욈
qxa	욉
qxh	욊
qxb	욋
qxm	욌
qxq	욍
qxu	욎
qxd	욏
qxz	욐
qxe	욑
qxx	욒
qxw	욓
qmf	욖
qmv	욗
qmk	욙
qmg	욚
qmj	욝
qmn	욞
qmr	욟
qmp	욠
qmt	욡
qmi	욢
qwm	욣
qmh	욦
qmm	욨
qtf	욲
qtv	욳
qtk	욵
qtg	욶
qtj	욹
qtn	욺
qtr	욻
qtp	욼
qtt	욽
qti	욾
qwt	욿
qth	웂
qtm	웄
qa	워
qay	웍
qaf	웎
qav	웏
qal	원
qak	웑
qag	웒
qac	웓
qas	월
qaj	웕
qan	웖
qar	웗
qap	웘
qat	웙
qai	웚
qwa	웛
qao	웜
qaa	웝
qah	웞
qab	웟
qam	웠
qaq	웡
qau	웢
qad	웣
qaz	웤
qae	웥
qax	웦
qaw	웧
qz	웨
qzy	웩
qzf	웪
qzv	웫
qzl	웬
qzk	웭
qzg	웮
qzc	웯
qzs	웰
qzj	웱
qzn	웲
qzr	웳
qzp	웴
qzt	웵
qzi	웶
qwz	웷
qzo	웸
qza	웹
qzh	웺
qzb	웻
qzm	웼
qzq	웽
qzu	웾
qzd	웿
qzz	윀
qze	윁
qzx	윂
qzw	윃
qd	위
qdy	윅
qdf	윆
qdv	윇
qdl	윈
qdk	윉
qdg	윊
qdc	윋
qds	윌
qdj	윍
qdn	윎
qdr	윏
qdp	윐
qdt	윑
qdi	윒
qwd	윓
qdo	윔
qda	윕
qdh	윖
qdb	윗
qdm	윘
qdq	윙
qdu	윚
qdd	윛
qdz	윜
qde	윝
qdx	윞
qdw	윟
qrf	윢
qrv	윣
qrk	윥
qrg	윦
qrj	윩
qrn	윪
qrr	윫
qrp	윬
qrt	윭
qri	윮
qwr	윯
qrh	윲
qrm	윴
qvf	윾
qvv	윿
qvk	읁
qvg	읂
qvj	읅
qvn	읆
qvr	읇
qvp	읈
qvt	읉
qvi	읊
qwv	읋
qvh	읎
qvm	읐
ql	의
qly	읙
qlf	읚
qlv	읛
qll	읜
qlk	읝
qlg	읞
qlc	읟
qls	읠
qlj	읡
qln	읢
qlr	읣
qlp	읤
qlt	읥
qli	읦
qwl	읧
qlo	읨
qla	읩
qlh	읪
qlb	읫
qlm	읬
qlq	읭
qlu	읮
qld	읯
qlz	읰
qle	읱
qlx	읲
qlw	읳
qif	읶
qiv	읷
qik	읹
qig	읺
qij	읽
qin	읾
qir	읿
qip	잀
qit	잁
qii	잂
qwi	잃
qih	잆
qim	있
#s13
ukf	잒
ukv	잓
ukk	잕
ukg	잖
ukj	잙
ukn	잚
ukr	잛
ukp	잜
ukt	잝
uki	잞
uwk	잟
ukh	잢
ukm	잤
uhf	잮
uhv	잯
uhk	잱
uhg	잲
uhj	잵
uhn	잶
uhr	잷
uhp	잸
uht	잹
uhi	잺
uwh	잻
uhh	잾
uhm	쟀
uff	쟊
ufv	쟋
ufk	쟍
ufg	쟎
ufj	쟑
ufn	쟒
ufr	쟓
ufp	쟔
uft	쟕
ufi	쟖
uwf	쟗
ufh	쟚
ufm	쟜
uo	쟤
uoy	쟥
uof	쟦
uov	쟧
uol	쟨
uok	쟩
uog	쟪
uoc	쟫
uos	쟬
uoj	쟭
uon	쟮
uor	쟯
uop	쟰
uot	쟱
uoi	쟲
uwo	쟳
uoo	쟴
uoa	쟵
uoh	쟶
uob	쟷
uom	쟸
uoq	쟹
uou	쟺
uod	쟻
uoz	쟼
uoe	쟽
uox	쟾
uow	쟿
ujf	젂
ujv	젃
ujk	젅
ujg	젆
ujj	젉
ujn	젊
ujr	젋
ujp	젌
ujt	젍
uji	젎
uwj	젏
ujh	젒
ujm	젔
upf	젞
upv	젟
upk	젡
upg	젢
upj	젥
upn	젦
upr	젧
upp	젨
upt	젩
upi	젪
uwp	젫
uph	젮
upm	젰
ugf	젺
ugv	젻
ugk	젽
ugg	젾
ugj	졁
ugn	졂
ugr	졃
ugp	졄
ugt	졅
ugi	졆
uwg	졇
ugh	졊
ugm	졌
uq	졔
uqy	졕
uqf	졖
uqv	졗
uql	졘
uqk	졙
uqg	졚
uqc	졛
uqs	졜
uqj	졝
uqn	졞
uqr	졟
uqp	졠
uqt	졡
uqi	졢
uwq	졣
uqo	졤
uqa	졥
uqh	졦
uqb	졧
uqm	졨
uqq	졩
uqu	졪
uqd	졫
uqz	졬
uqe	졭
uqx	졮
uqw	졯
unf	졲
unv	졳
unk	졵
ung	졶
unj	졹
unn	졺
unr	졻
unp	졼
unt	졽
uni	졾
uwn	졿
unh	좂
unm	좄
ue	좌
uey	좍
uef	좎
uev	좏
uel	좐
uek	좑
ueg	좒
uec	좓
ues	좔
uej	좕
uen	좖
uer	좗
uep	좘
uet	좙
uei	좚
uwe	좛
ueo	좜
uea	좝
ueh	좞
ueb	좟
uem	좠
ueq	좡
ueu	좢
ued	좣
uez	좤
uee	좥
uex	좦
uew	좧
us	좨
usy	좩
usf	좪
usv	좫
usl	좬
usk	좭
usg	좮
usc	좯
uss	좰
usj	좱
usn	좲
usr	좳
usp	좴
ust	좵
usi	좶
uws	좷
uso	좸
usa	좹
ush	좺
usb	좻
usm	좼
usq	좽
usu	좾
usd	좿
usz	죀
use	죁
usx	죂
usw	죃
ux	죄
uxy	죅
uxf	죆
uxv	죇
uxl	죈
uxk	죉
uxg	죊
uxc	죋
uxs	죌
uxj	죍
uxn	죎
uxr	죏
uxp	죐
uxt	죑
uxi	죒
uwx	죓
uxo	죔
uxa	죕
uxh	죖
uxb	죗
uxm	죘
uxq	죙
uxu	죚
uxd	죛
uxz	죜
uxe	죝
uxx	죞
uxw	죟
umf	죢
umv	죣
umk	죥
umg	죦
umj	죩
umn	죪
umr	죫
ump	죬
umt	죭
umi	죮
uwm	죯
umh	죲
umm	죴
utf	죾
utv	죿
utk	줁
utg	줂
utj	줅
utn	줆
utr	줇
utp	줈
utt	줉
uti	줊
uwt	줋
uth	줎
utm	줐
ua	줘
uay	줙
uaf	줚
uav	줛
ual	줜
uak	줝
uag	줞
uac	줟
uas	줠
uaj	줡
uan	줢
uar	줣
uap	줤
uat	줥
uai	줦
uwa	줧
uao	줨
uaa	줩
uah	줪
uab	줫
uam	줬
uaq	줭
uau	줮
uad	줯
uaz	줰
uae	줱
uax	줲
uaw	줳
uz	줴
uzy	줵
uzf	줶
uzv	줷
uzl	줸
uzk	줹
uzg	줺
uzc	줻
uzs	줼
uzj	줽
uzn	줾
uzr	줿
uzp	쥀
uzt	쥁
uzi	쥂
uwz	쥃
uzo	쥄
uza	쥅
uzh	쥆
uzb	쥇
uzm	쥈
uzq	쥉
uzu	쥊
uzd	쥋
uzz	쥌
uze	쥍
uzx	쥎
uzw	쥏
ud	쥐
udy	쥑
udf	쥒
udv	쥓
udl	쥔
udk	쥕
udg	쥖
udc	쥗
uds	쥘
udj	쥙
udn	쥚
udr	쥛
udp	쥜
udt	쥝
udi	쥞
uwd	쥟
udo	쥠
uda	쥡
udh	쥢
udb	쥣
udm	쥤
udq	쥥
udu	쥦
udd	쥧
udz	쥨
ude	쥩
udx	쥪
udw	쥫
urf	쥮
urv	쥯
urk	쥱
urg	쥲
urj	쥵
urn	쥶
urr	쥷
urp	쥸
urt	쥹
uri	쥺
uwr	쥻
urh	쥾
urm	즀
uvf	즊
uvv	즋
uvk	즍
uvg	즎
uvj	즑
uvn	즒
uvr	즓
uvp	즔
uvt	즕
uvi	즖
uwv	즗
uvh	즚
uvm	즜
ul	즤
uly	즥
ulf	즦
ulv	즧
ull	즨
ulk	즩
ulg	즪
ulc	즫
uls	즬
ulj	즭
uln	즮
ulr	즯
ulp	즰
ult	즱
uli	즲
uwl	즳
ulo	즴
ula	즵
ulh	즶
ulb	즷
ulm	즸
ulq	즹
ulu	즺
uld	즻
ulz	즼
ule	즽
ulx	즾
ulw	즿
uif	짂
uiv	짃
uik	짅
uig	짆
uij	짉
uin	짊
uir	짋
uip	짌
uit	짍
uii	짎
uwi	짏
uih	짒
uim	짔
#s14
kk	짜
kky	짝
kkf	짞
kkv	짟
kkl	짠
kkk	짡
kkg	짢
kkc	짣
kks	짤
kkj	짥
kkn	짦
kkr	짧
kkp	짨
kkt	짩
kki	짪
kwk	짫
kko	짬
kka	짭
kkh	짮
kkb	짯
kkm	짰
kkq	짱
kku	짲
kkd	짳
kkz	짴
kke	짵
kkx	짶
kkw	짷
kh	째
khy	짹
khf	짺
khv	짻
khl	짼
khk	짽
khg	짾
khc	짿
khs	쨀
khj	쨁
khn	쨂
khr	쨃
khp	쨄
kht	쨅
khi	쨆
kwh	쨇
kho	쨈
kha	쨉
khh	쨊
khb	쨋
khm	쨌
khq	쨍
khu	쨎
khd	쨏
khz	쨐
khe	쨑
khx	쨒
khw	쨓
kf	쨔
kfy	쨕
kff	쨖
kfv	쨗
kfl	쨘
kfk	쨙
kfg	쨚
kfc	쨛
kfs	쨜
kfj	쨝
kfn	쨞
kfr	쨟
kfp	쨠
kft	쨡
kfi	쨢
kwf	쨣
kfo	쨤
kfa	쨥
kfh	쨦
kfb	쨧
kfm	쨨
kfq	쨩
kfu	쨪
kfd	쨫
kfz	쨬
kfe	쨭
kfx	쨮
kfw	쨯
ko	쨰
koy	쨱
kof	쨲
kov	쨳
kol	쨴
kok	쨵
kog	쨶
koc	쨷
kos	쨸
koj	쨹
kon	쨺
kor	쨻
kop	쨼
kot	쨽
koi	쨾
kwo	쨿
koo	쩀
koa	쩁
koh	쩂
kob	쩃
kom	쩄
koq	쩅
kou	쩆
kod	쩇
koz	쩈
koe	쩉
kox	쩊
kow	쩋
kj	쩌
kjy	쩍
kjf	쩎
kjv	쩏
kjl	쩐
kjk	쩑
kjg	쩒
kjc	쩓
kjs	쩔
kjj	쩕
kjn	쩖
kjr	쩗
kjp	쩘
kjt	쩙
kji	쩚
kwj	쩛
kjo	쩜
kja	쩝
kjh	쩞
kjb	쩟
kjm	쩠
kjq	쩡
kju	쩢
kjd	쩣
kjz	쩤
kje	쩥
kjx	쩦
kjw	쩧
kp	쩨
kpy	쩩
kpf	쩪
kpv	쩫
kpl	쩬
kpk	쩭
kpg	쩮
kpc	쩯
kps	쩰
kpj	쩱
kpn	쩲
kpr	쩳
kpp	쩴
kpt	쩵
kpi	쩶
kwp	쩷
kpo	쩸
kpa	쩹
kph	쩺
kpb	쩻
kpm	쩼
kpq	쩽
kpu	쩾
kpd	쩿
kpz	쪀
kpe	쪁
kpx	쪂
kpw	쪃
kg	쪄
kgy	쪅
kgf	쪆
kgv	쪇
kgl	쪈
kgk	쪉
kgg	쪊
kgc	쪋
kgs	쪌
kgj	쪍
kgn	쪎
kgr	쪏
kgp	쪐
kgt	쪑
kgi	쪒
kwg	쪓
kgo	쪔
kga	쪕
kgh	쪖
kgb	쪗
kgm	쪘
kgq	쪙
kgu	쪚
kgd	쪛
kgz	쪜
kge	쪝
kgx	쪞
kgw	쪟
kq	쪠
kqy	쪡
kqf	쪢
kqv	쪣
kql	쪤
kqk	쪥
kqg	쪦
kqc	쪧
kqs	쪨
kqj	쪩
kqn	쪪
kqr	쪫
kqp	쪬
kqt	쪭
kqi	쪮
kwq	쪯
kqo	쪰
kqa	쪱
kqh	쪲
kqb	쪳
kqm	쪴
kqq	쪵
kqu	쪶
kqd	쪷
kqz	쪸
kqe	쪹
kqx	쪺
kqw	쪻
kn	쪼
kny	쪽
knf	쪾
knv	쪿
knl	쫀
knk	쫁
kng	쫂
knc	쫃
kns	쫄
knj	쫅
knn	쫆
knr	쫇
knp	쫈
knt	쫉
kni	쫊
kwn	쫋
kno	쫌
kna	쫍
knh	쫎
knb	쫏
knm	쫐
knq	쫑
knu	쫒
knd	쫓
knz	쫔
kne	쫕
knx	쫖
knw	쫗
ke	쫘
key	쫙
kef	쫚
kev	쫛
kel	쫜
kek	쫝
keg	쫞
kec	쫟
kes	쫠
kej	쫡
ken	쫢
ker	쫣
kep	쫤
ket	쫥
kei	쫦
kwe	쫧
keo	쫨
kea	쫩
keh	쫪
keb	쫫
kem	쫬
keq	쫭
keu	쫮
ked	쫯
kez	쫰
kee	쫱
kex	쫲
kew	쫳
ks	쫴
ksy	쫵
ksf	쫶
ksv	쫷
ksl	쫸
ksk	쫹
ksg	쫺
ksc	쫻
kss	쫼
ksj	쫽
ksn	쫾
ksr	쫿
ksp	쬀
kst	쬁
ksi	쬂
kws	쬃
kso	쬄
ksa	쬅
ksh	쬆
ksb	쬇
ksm	쬈
ksq	쬉
ksu	쬊
ksd	쬋
ksz	쬌
kse	쬍
ksx	쬎
ksw	쬏
kx	쬐
kxy	쬑
kxf	쬒
kxv	쬓
kxl	쬔
kxk	쬕
kxg	쬖
kxc	쬗
kxs	쬘
kxj	쬙
kxn	쬚
kxr	쬛
kxp	쬜
kxt	쬝
kxi	쬞
kwx	쬟
kxo	쬠
kxa	쬡
kxh	쬢
kxb	쬣
kxm	쬤
kxq	쬥
kxu	쬦
kxd	쬧
kxz	쬨
kxe	쬩
kxx	쬪
kxw	쬫
km	쬬
kmy	쬭
kmf	쬮
kmv	쬯
kml	쬰
kmk	쬱
kmg	쬲
kmc	쬳
kms	쬴
kmj	쬵
kmn	쬶
kmr	쬷
kmp	쬸
kmt	쬹
kmi	쬺
kwm	쬻
kmo	쬼
kma	쬽
kmh	쬾
kmb	쬿
kmm	쭀
kmq	쭁
kmu	쭂
kmd	쭃
kmz	쭄
kme	쭅
kmx	쭆
kmw	쭇
kt	쭈
kty	쭉
ktf	쭊
ktv	쭋
ktl	쭌
ktk	쭍
ktg	쭎
ktc	쭏
kts	쭐
ktj	쭑
ktn	쭒
ktr	쭓
ktp	쭔
ktt	쭕
kti	쭖
kwt	쭗
kto	쭘
kta	쭙
kth	쭚
ktb	쭛
ktm	쭜
ktq	쭝
ktu	쭞
ktd	쭟
ktz	쭠
kte	쭡
ktx	쭢
ktw	쭣
ka	쭤
kay	쭥
kaf	쭦
kav	쭧
kal	쭨
kak	쭩
kag	쭪
kac	쭫
kas	쭬
kaj	쭭
kan	쭮
kar	쭯
kap	쭰
kat	쭱
kai	쭲
kwa	쭳
kao	쭴
kaa	쭵
kah	쭶
kab	쭷
kam	쭸
kaq	쭹
kau	쭺
kad	쭻
kaz	쭼
kae	쭽
kax	쭾
kaw	쭿
kz	쮀
kzy	쮁
kzf	쮂
kzv	쮃
kzl	쮄
kzk	쮅
kzg	쮆
kzc	쮇
kzs	쮈
kzj	쮉
kzn	쮊
kzr	쮋
kzp	쮌
kzt	쮍
kzi	쮎
kwz	쮏
kzo	쮐
kza	쮑
kzh	쮒
kzb	쮓
kzm	쮔
kzq	쮕
kzu	쮖
kzd	쮗
kzz	쮘
kze	쮙
kzx	쮚
kzw	쮛
kd	쮜
kdy	쮝
kdf	쮞
kdv	쮟
kdl	쮠
kdk	쮡
kdg	쮢
kdc	쮣
kds	쮤
kdj	쮥
kdn	쮦
kdr	쮧
kdp	쮨
kdt	쮩
kdi	쮪
kwd	쮫
kdo	쮬
kda	쮭
kdh	쮮
kdb	쮯
kdm	쮰
kdq	쮱
kdu	쮲
kdd	쮳
kdz	쮴
kde	쮵
kdx	쮶
kdw	쮷
kr	쮸
kry	쮹
krf	쮺
krv	쮻
krl	쮼
krk	쮽
krg	쮾
krc	쮿
krs	쯀
krj	쯁
krn	쯂
krr	쯃
krp	쯄
krt	쯅
kri	쯆
kwr	쯇
kro	쯈
kra	쯉
krh	쯊
krb	쯋
krm	쯌
krq	쯍
kru	쯎
krd	쯏
krz	쯐
kre	쯑
krx	쯒
krw	쯓
kv	쯔
kvy	쯕
kvf	쯖
kvv	쯗
kvl	쯘
kvk	쯙
kvg	쯚
kvc	쯛
kvs	쯜
kvj	쯝
kvn	쯞
kvr	쯟
kvp	쯠
kvt	쯡
kvi	쯢
kwv	쯣
kvo	쯤
kva	쯥
kvh	쯦
kvb	쯧
kvm	쯨
kvq	쯩
kvu	쯪
kvd	쯫
kvz	쯬
kve	쯭
kvx	쯮
kvw	쯯
kl	쯰
kly	쯱
klf	쯲
klv	쯳
kll	쯴
klk	쯵
klg	쯶
klc	쯷
kls	쯸
klj	쯹
kln	쯺
klr	쯻
klp	쯼
klt	쯽
kli	쯾
kwl	쯿
klo	찀
kla	찁
klh	찂
klb	찃
klm	찄
klq	찅
klu	찆
kld	찇
klz	찈
kle	찉
klx	찊
klw	찋
ki	찌
kiy	찍
kif	찎
kiv	찏
kil	찐
kik	찑
kig	찒
kic	찓
kis	찔
kij	찕
kin	찖
kir	찗
kip	찘
kit	찙
kii	찚
kwi	찛
kio	찜
kia	찝
kih	찞
kib	찟
kim	찠
kiq	찡
kiu	찢
kid	찣
kiz	찤
kie	찥
kix	찦
kiw	찧
#s15
dkf	찪
dkv	찫
dkk	찭
dkg	찮
dkj	찱
dkn	찲
dkr	찳
dkp	찴
dkt	찵
dki	찶
dwk	찷
dkh	찺
dkm	찼
dhf	챆
dhv	챇
dhk	챉
dhg	챊
dhj	챍
dhn	챎
dhr	챏
dhp	챐
dht	챑
dhi	챒
dwh	챓
dhh	챖
dhm	챘
dff	챢
dfv	챣
dfk	챥
dfg	챦
dfj	챩
dfn	챪
dfr	챫
dfp	챬
dft	챭
dfi	챮
dwf	챯
dfh	챲
dfm	챴
do	챼
doy	챽
dof	챾
dov	챿
dol	첀
dok	첁
dog	첂
doc	첃
dos	첄
doj	첅
don	첆
dor	첇
dop	첈
dot	첉
doi	첊
dwo	첋
doo	첌
doa	첍
doh	첎
dob	첏
dom	첐
doq	첑
dou	첒
dod	첓
doz	첔
doe	첕
dox	첖
dow	첗
djf	첚
djv	첛
djk	첝
djg	첞
djj	첡
djn	첢
djr	첣
djp	첤
djt	첥
dji	첦
dwj	첧
djh	첪
djm	첬
dpf	첶
dpv	첷
dpk	첹
dpg	첺
dpj	첽
dpn	첾
dpr	첿
dpp	쳀
dpt	쳁
dpi	쳂
dwp	쳃
dph	쳆
dpm	쳈
dgf	쳒
dgv	쳓
dgk	쳕
dgg	쳖
dgj	쳙
dgn	쳚
dgr	쳛
dgp	쳜
dgt	쳝
dgi	쳞
dwg	쳟
dgh	쳢
dgm	쳤
dq	쳬
dqy	쳭
dqf	쳮
dqv	쳯
dql	쳰
dqk	쳱
dqg	쳲
dqc	쳳
dqs	쳴
dqj	쳵
dqn	쳶
dqr	쳷
dqp	쳸
dqt	쳹
dqi	쳺
dwq	쳻
dqo	쳼
dqa	쳽
dqh	쳾
dqb	쳿
dqm	촀
dqq	촁
dqu	촂
dqd	촃
dqz	촄
dqe	촅
dqx	촆
dqw	촇
dnf	촊
dnv	촋
dnk	촍
dng	촎
dnj	촑
dnn	촒
dnr	촓
dnp	촔
dnt	촕
dni	촖
dwn	촗
dnh	촚
dnm	촜
de	촤
dey	촥
def	촦
dev	촧
del	촨
dek	촩
deg	촪
dec	촫
des	촬
dej	촭
den	촮
der	촯
dep	촰
det	촱
dei	촲
dwe	촳
deo	촴
dea	촵
deh	촶
deb	촷
dem	촸
deq	촹
deu	촺
ded	촻
dez	촼
dee	촽
dex	촾
dew	촿
ds	쵀
dsy	쵁
dsf	쵂
dsv	쵃
dsl	쵄
dsk	쵅
dsg	쵆
dsc	쵇
dss	쵈
dsj	쵉
dsn	쵊
dsr	쵋
dsp	쵌
dst	쵍
dsi	쵎
dws	쵏
dso	쵐
dsa	쵑
dsh	쵒
dsb	쵓
dsm	쵔
dsq	쵕
dsu	쵖
dsd	쵗
dsz	쵘
dse	쵙
dsx	쵚
dsw	쵛
dx	최
dxy	쵝
dxf	쵞
dxv	쵟
dxl	쵠
dxk	쵡
dxg	쵢
dxc	쵣
dxs	쵤
dxj	쵥
dxn	쵦
dxr	쵧
dxp	쵨
dxt	쵩
dxi	쵪
dwx	쵫
dxo	쵬
dxa	쵭
dxh	쵮
dxb	쵯
dxm	쵰
dxq	쵱
dxu	쵲
dxd	쵳
dxz	쵴
dxe	쵵
dxx	쵶
dxw	쵷
dmf	쵺
dmv	쵻
dmk	쵽
dmg	쵾
dmj	춁
dmn	춂
dmr	춃
dmp	춄
dmt	춅
dmi	춆
dwm	춇
dmh	춊
dmm	춌
dtf	춖
dtv	춗
dtk	춙
dtg	춚
dtj	춝
dtn	춞
dtr	춟
dtp	춠
dtt	춡
dti	춢
dwt	춣
dth	춦
dtm	춨
da	춰
day	춱
daf	춲
dav	춳
dal	춴
dak	춵
dag	춶
dac	춷
das	춸
daj	춹
dan	춺
dar	춻
dap	춼
dat	춽
dai	춾
dwa	춿
dao	췀
daa	췁
dah	췂
dab	췃
dam	췄
daq	췅
dau	췆
dad	췇
daz	췈
dae	췉
dax	췊
daw	췋
dz	췌
dzy	췍
dzf	췎
dzv	췏
dzl	췐
dzk	췑
dzg	췒
dzc	췓
dzs	췔
dzj	췕
dzn	췖
dzr	췗
dzp	췘
dzt	췙
dzi	췚
dwz	췛
dzo	췜
dza	췝
dzh	췞
dzb	췟
dzm	췠
dzq	췡
dzu	췢
dzd	췣
dzz	췤
dze	췥
dzx	췦
dzw	췧
dd	취
ddy	췩
ddf	췪
ddv	췫
ddl	췬
ddk	췭
ddg	췮
ddc	췯
dds	췰
ddj	췱
ddn	췲
ddr	췳
ddp	췴
ddt	췵
ddi	췶
dwd	췷
ddo	췸
dda	췹
ddh	췺
ddb	췻
ddm	췼
ddq	췽
ddu	췾
ddd	췿
ddz	츀
dde	츁
ddx	츂
ddw	츃
drf	츆
drv	츇
drk	츉
drg	츊
drj	츍
drn	츎
drr	츏
drp	츐
drt	츑
dri	츒
dwr	츓
drh	츖
drm	츘
dvf	츢
dvv	츣
dvk	츥
dvg	츦
dvj	츩
dvn	츪
dvr	츫
dvp	츬
dvt	츭
dvi	츮
dwv	츯
dvh	츲
dvm	츴
dl	츼
dly	츽
dlf	츾
dlv	츿
dll	칀
dlk	칁
dlg	칂
dlc	칃
dls	칄
dlj	칅
dln	칆
dlr	칇
dlp	칈
dlt	칉
dli	칊
dwl	칋
dlo	칌
dla	칍
dlh	칎
dlb	칏
dlm	칐
dlq	칑
dlu	칒
dld	칓
dlz	칔
dle	칕
dlx	칖
dlw	칗
dif	칚
div	칛
dik	칝
dig	칞
dij	칡
din	칢
dir	칣
dip	칤
dit	칥
dii	칦
dwi	칧
dih	칪
dim	칬
#s16
zkf	칶
zkv	칷
zkk	칹
zkg	칺
zkj	칽
zkn	칾
zkr	칿
zkp	캀
zkt	캁
zki	캂
zwk	캃
zkh	캆
zkm	캈
zhf	캒
zhv	캓
zhk	캕
zhg	캖
zhj	캙
zhn	캚
zhr	캛
zhp	캜
zht	캝
zhi	캞
zwh	캟
zhh	캢
zhm	캤
zff	캮
zfv	캯
zfk	캱
zfg	캲
zfj	캵
zfn	캶
zfr	캷
zfp	캸
zft	캹
zfi	캺
zwf	캻
zfh	캾
zfm	컀
zo	컈
zoy	컉
zof	컊
zov	컋
zol	컌
zok	컍
zog	컎
zoc	컏
zos	컐
zoj	컑
zon	컒
zor	컓
zop	컔
zot	컕
zoi	컖
zwo	컗
zoo	컘
zoa	컙
zoh	컚
zob	컛
zom	컜
zoq	컝
zou	컞
zod	컟
zoz	컠
zoe	컡
zox	컢
zow	컣
zjf	컦
zjv	컧
zjk	컩
zjg	컪
zjj	컭
zjn	컮
zjr	컯
zjp	컰
zjt	컱
zji	컲
zwj	컳
zjh	컶
zjm	컸
zpf	켂
zpv	켃
zpk	켅
zpg	켆
zpj	켉
zpn	켊
zpr	켋
zpp	켌
zpt	켍
zpi	켎
zwp	켏
zph	켒
zpm	켔
zgf	켞
zgv	켟
zgk	켡
zgg	켢
zgj	켥
zgn	켦
zgr	켧
zgp	켨
zgt	켩
zgi	켪
zwg	켫
zgh	켮
zgm	켰
zq	켸
zqy	켹
zqf	켺
zqv	켻
zql	켼
zqk	켽
zqg	켾
zqc	켿
zqs	콀
zqj	콁
zqn	콂
zqr	콃
zqp	콄
zqt	콅
zqi	콆
zwq	콇
zqo	콈
zqa	콉
zqh	콊
zqb	콋
zqm	콌
zqq	콍
zqu	콎
zqd	콏
zqz	콐
zqe	콑
zqx	콒
zqw	콓
znf	콖
znv	콗
znk	콙
zng	콚
znj	콝
znn	콞
znr	콟
znp	콠
znt	콡
zni	콢
zwn	콣
znh	콦
znm	콨
ze	콰
zey	콱
zef	콲
zev	콳
zel	콴
zek	콵
zeg	콶
zec	콷
zes	콸
zej	콹
zen	콺
zer	콻
zep	콼
zet	콽
zei	콾
zwe	콿
zeo	쾀
zea	쾁
zeh	쾂
zeb	쾃
zem	쾄
zeq	쾅
zeu	쾆
zed	쾇
zez	쾈
zee	쾉
zex	쾊
zew	쾋
zs	쾌
zsy	쾍
zsf	쾎
zsv	쾏
zsl	쾐
zsk	쾑
zsg	쾒
zsc	쾓
zss	쾔
zsj	쾕
zsn	쾖
zsr	쾗
zsp	쾘
zst	쾙
zsi	쾚
zws	쾛
zso	쾜
zsa	쾝
zsh	쾞
zsb	쾟
zsm	쾠
zsq	쾡
zsu	쾢
zsd	쾣
zsz	쾤
zse	쾥
zsx	쾦
zsw	쾧
zx	쾨
zxy	쾩
zxf	쾪
zxv	쾫
zxl	쾬
zxk	쾭
zxg	쾮
zxc	쾯
zxs	쾰
zxj	쾱
zxn	쾲
zxr	쾳
zxp	쾴
zxt	쾵
zxi	쾶
zwx	쾷
zxo	쾸
zxa	쾹
zxh	쾺
zxb	쾻
zxm	쾼
zxq	쾽
zxu	쾾
zxd	쾿
zxz	쿀
zxe	쿁
zxx	쿂
zxw	쿃
zmf	쿆
zmv	쿇
zmk	쿉
zmg	쿊
zmj	쿍
zmn	쿎
zmr	쿏
zmp	쿐
zmt	쿑
zmi	쿒
zwm	쿓
zmh	쿖
zmm	쿘
ztf	쿢
ztv	쿣
ztk	쿥
ztg	쿦
ztj	쿩
ztn	쿪
ztr	쿫
ztp	쿬
ztt	쿭
zti	쿮
zwt	쿯
zth	쿲
ztm	쿴
za	쿼
zay	쿽
zaf	쿾
zav	쿿
zal	퀀
zak	퀁
zag	퀂
zac	퀃
zas	퀄
zaj	퀅
zan	퀆
zar	퀇
zap	퀈
zat	퀉
zai	퀊
zwa	퀋
zao	퀌
zaa	퀍
zah	퀎
zab	퀏
zam	퀐
zaq	퀑
zau	퀒
zad	퀓
zaz	퀔
zae	퀕
zax	퀖
zaw	퀗
zz	퀘
zzy	퀙
zzf	퀚
zzv	퀛
zzl	퀜
zzk	퀝
zzg	퀞
zzc	퀟
zzs	퀠
zzj	퀡
zzn	퀢
zzr	퀣
zzp	퀤
zzt	퀥
zzi	퀦
zwz	퀧
zzo	퀨
zza	퀩
zzh	퀪
zzb	퀫
zzm	퀬
zzq	퀭
zzu	퀮
zzd	퀯
zzz	퀰
zze	퀱
zzx	퀲
zzw	퀳
zd	퀴
zdy	퀵
zdf	퀶
zdv	퀷
zdl	퀸
zdk	퀹
zdg	퀺
zdc	퀻
zds	퀼
zdj	퀽
zdn	퀾
zdr	퀿
zdp	큀
zdt	큁
zdi	큂
zwd	큃
zdo	큄
zda	큅
zdh	큆
zdb	큇
zdm	큈
zdq	큉
zdu	큊
zdd	큋
zdz	큌
zde	큍
zdx	큎
zdw	큏
zrf	큒
zrv	큓
zrk	큕
zrg	큖
zrj	큙
zrn	큚
zrr	큛
zrp	큜
zrt	큝
zri	큞
zwr	큟
zrh	큢
zrm	큤
zvf	큮
zvv	큯
zvk	큱
zvg	큲
zvj	큵
zvn	큶
zvr	큷
zvp	큸
zvt	큹
zvi	큺
zwv	큻
zvh	큾
zvm	킀
zl	킈
zly	킉
zlf	킊
zlv	킋
zll	킌
zlk	킍
zlg	킎
zlc	킏
zls	킐
zlj	킑
zln	킒
zlr	킓
zlp	킔
zlt	킕
zli	킖
zwl	킗
zlo	킘
zla	킙
zlh	킚
zlb	킛
zlm	킜
zlq	킝
zlu	킞
zld	킟
zlz	킠
zle	킡
zlx	킢
zlw	킣
zif	킦
ziv	킧
zik	킩
zig	킪
zij	킭
zin	킮
zir	킯
zip	킰
zit	킱
zii	킲
zwi	킳
zih	킶
zim	킸
#s17
ekf	탂
ekv	탃
ekk	탅
ekg	탆
ekj	탉
ekn	탊
ekr	탋
ekp	탌
ekt	탍
eki	탎
ewk	탏
ekh	탒
ekm	탔
ehf	탞
ehv	탟
ehk	탡
ehg	탢
ehj	탥
ehn	탦
ehr	탧
ehp	탨
eht	탩
ehi	탪
ewh	탫
ehh	탮
ehm	탰
eff	탺
efv	탻
efk	탽
efg	탾
efj	턁
efn	턂
efr	턃
efp	턄
eft	턅
efi	턆
ewf	턇
efh	턊
efm	턌
eo	턔
eoy	턕
eof	턖
eov	턗
eol	턘
eok	턙
eog	턚
eoc	턛
eos	턜
eoj	턝
eon	턞
eor	턟
eop	턠
eot	턡
eoi	턢
ewo	턣
eoo	턤
eoa	턥
eoh	턦
eob	턧
eom	턨
eoq	턩
eou	턪
eod	턫
eoz	턬
eoe	턭
eox	턮
eow	턯
ejf	턲
ejv	턳
ejk	턵
ejg	턶
ejj	턹
ejn	턺
ejr	턻
ejp	턼
ejt	턽
eji	턾
ewj	턿
ejh	텂
ejm	텄
epf	텎
epv	텏
epk	텑
epg	텒
epj	텕
epn	텖
epr	텗
epp	텘
ept	텙
epi	텚
ewp	텛
eph	텞
epm	텠
egf	텪
egv	텫
egk	텭
egg	텮
egj	텱
egn	텲
egr	텳
egp	텴
egt	텵
egi	텶
ewg	텷
egh	텺
egm	텼
eq	톄
eqy	톅
eqf	톆
eqv	톇
eql	톈
eqk	톉
eqg	톊
eqc	톋
eqs	톌
eqj	톍
eqn	톎
eqr	톏
eqp	톐
eqt	톑
eqi	톒
ewq	톓
eqo	톔
eqa	톕
eqh	톖
eqb	톗
eqm	톘
eqq	톙
equ	톚
eqd	톛
eqz	톜
eqe	톝
eqx	톞
eqw	톟
enf	톢
env	톣
enk	톥
eng	톦
enj	톩
enn	톪
enr	톫
enp	톬
ent	톭
eni	톮
ewn	톯
enh	톲
enm	톴
ee	톼
eey	톽
eef	톾
eev	톿
eel	퇀
eek	퇁
eeg	퇂
eec	퇃
ees	퇄
eej	퇅
een	퇆
eer	퇇
eep	퇈
eet	퇉
eei	퇊
ewe	퇋
eeo	퇌
eea	퇍
eeh	퇎
eeb	퇏
eem	퇐
eeq	퇑
eeu	퇒
eed	퇓
eez	퇔
eee	퇕
eex	퇖
eew	퇗
es	퇘
esy	퇙
esf	퇚
esv	퇛
esl	퇜
esk	퇝
esg	퇞
esc	퇟
ess	퇠
esj	퇡
esn	퇢
esr	퇣
esp	퇤
est	퇥
esi	퇦
ews	퇧
eso	퇨
esa	퇩
esh	퇪
esb	퇫
esm	퇬
esq	퇭
esu	퇮
esd	퇯
esz	퇰
ese	퇱
esx	퇲
esw	퇳
ex	퇴
exy	퇵
exf	퇶
exv	퇷
exl	퇸
exk	퇹
exg	퇺
exc	퇻
exs	퇼
exj	퇽
exn	퇾
exr	퇿
exp	툀
ext	툁
exi	툂
ewx	툃
exo	툄
exa	툅
exh	툆
exb	툇
exm	툈
exq	툉
exu	툊
exd	툋
exz	툌
exe	툍
exx	툎
exw	툏
emf	툒
emv	툓
emk	툕
emg	툖
emj	툙
emn	툚
emr	툛
emp	툜
emt	툝
emi	툞
ewm	툟
emh	툢
emm	툤
etf	툮
etv	툯
etk	툱
etg	툲
etj	툵
etn	툶
etr	툷
etp	툸
ett	툹
eti	툺
ewt	툻
eth	툾
etm	퉀
ea	퉈
eay	퉉
eaf	퉊
eav	퉋
eal	퉌
eak	퉍
eag	퉎
eac	퉏
eas	퉐
eaj	퉑
ean	퉒
ear	퉓
eap	퉔
eat	퉕
eai	퉖
ewa	퉗
eao	퉘
eaa	퉙
eah	퉚
eab	퉛
eam	퉜
eaq	퉝
eau	퉞
ead	퉟
eaz	퉠
eae	퉡
eax	퉢
eaw	퉣
ez	퉤
ezy	퉥
ezf	퉦
ezv	퉧
ezl	퉨
ezk	퉩
ezg	퉪
ezc	퉫
ezs	퉬
ezj	퉭
ezn	퉮
ezr	퉯
ezp	퉰
ezt	퉱
ezi	퉲
ewz	퉳
ezo	퉴
eza	퉵
ezh	퉶
ezb	퉷
ezm	퉸
ezq	퉹
ezu	퉺
ezd	퉻
ezz	퉼
eze	퉽
ezx	퉾
ezw	퉿
ed	튀
edy	튁
edf	튂
edv	튃
edl	튄
edk	튅
edg	튆
edc	튇
eds	튈
edj	튉
edn	튊
edr	튋
edp	튌
edt	튍
edi	튎
ewd	튏
edo	튐
eda	튑
edh	튒
edb	튓
edm	튔
edq	튕
edu	튖
edd	튗
edz	튘
ede	튙
edx	튚
edw	튛
erf	튞
erv	튟
erk	튡
erg	튢
erj	튥
ern	튦
err	튧
erp	튨
ert	튩
eri	튪
ewr	튫
erh	튮
erm	튰
evf	튺
evv	튻
evk	튽
evg	튾
evj	틁
evn	틂
evr	틃
evp	틄
evt	틅
evi	틆
ewv	틇
evh	틊
evm	틌
el	틔
ely	틕
elf	틖
elv	틗
ell	틘
elk	틙
elg	틚
elc	틛
els	틜
elj	틝
eln	틞
elr	틟
elp	틠
elt	틡
eli	틢
ewl	틣
elo	틤
ela	틥
elh	틦
elb	틧
elm	틨
elq	틩
elu	틪
eld	틫
elz	틬
ele	틭
elx	틮
elw	틯
eif	틲
eiv	틳
eik	틵
eig	틶
eij	틹
ein	틺
eir	틻
eip	틼
eit	틽
eii	틾
ewi	틿
eih	팂
eim	팄
#s18
xkf	팎
xkv	팏
xkk	팑
xkg	팒
xkj	팕
xkn	팖
xkr	팗
xkp	팘
xkt	팙
xki	팚
xwk	팛
xkh	팞
xkm	팠
xhf	팪
xhv	팫
xhk	팭
xhg	팮
xhj	팱
xhn	팲
xhr	팳
xhp	팴
xht	팵
xhi	팶
xwh	팷
xhh	팺
xhm	팼
xff	퍆
xfv	퍇
xfk	퍉
xfg	퍊
xfj	퍍
xfn	퍎
xfr	퍏
xfp	퍐
xft	퍑
xfi	퍒
xwf	퍓
xfh	퍖
xfm	퍘
xo	퍠
xoy	퍡
xof	퍢
xov	퍣
xol	퍤
xok	퍥
xog	퍦
xoc	퍧
xos	퍨
xoj	퍩
xon	퍪
xor	퍫
xop	퍬
xot	퍭
xoi	퍮
xwo	퍯
xoo	퍰
xoa	퍱
xoh	퍲
xob	퍳
xom	퍴
xoq	퍵
xou	퍶
xod	퍷
xoz	퍸
xoe	퍹
xox	퍺
xow	퍻
xjf	퍾
xjv	퍿
xjk	펁
xjg	펂
xjj	펅
xjn	펆
xjr	펇
xjp	펈
xjt	펉
xji	펊
xwj	펋
xjh	펎
xjm	펐
xpf	펚
xpv	펛
xpk	펝
xpg	펞
xpj	펡
xpn	펢
xpr	펣
xpp	펤
xpt	펥
xpi	펦
xwp	펧
xph	펪
xpm	펬
xgf	펶
xgv	펷
xgk	펹
xgg	펺
xgj	펽
xgn	펾
xgr	펿
xgp	폀
xgt	폁
xgi	폂
xwg	폃
xgh	폆
xgm	폈
xq	폐
xqy	폑
xqf	폒
xqv	폓
xql	폔
xqk	폕
xqg	폖
xqc	폗
xqs	폘
xqj	폙
xqn	폚
xqr	폛
xqp	폜
xqt	폝
xqi	폞
xwq	폟
xqo	폠
xqa	폡
xqh	폢
xqb	폣
xqm	폤
xqq	폥
xqu	폦
xqd	폧
xqz	폨
xqe	폩
xqx	폪
xqw	폫
xnf	폮
xnv	폯
xnk	폱
xng	폲
xnj	폵
xnn	폶
xnr	폷
xnp	폸
xnt	폹
xni	폺
xwn	폻
xnh	폾
xnm	퐀
xe	퐈
xey	퐉
xef	퐊
xev	퐋
xel	퐌
xek	퐍
xeg	퐎
xec	퐏
xes	퐐
xej	퐑
xen	퐒
xer	퐓
xep	퐔
xet	퐕
xei	퐖
xwe	퐗
xeo	퐘
xea	퐙
xeh	퐚
xeb	퐛
xem	퐜
xeq	퐝
xeu	퐞
xed	퐟
xez	퐠
xee	퐡
xex	퐢
xew	퐣
xs	퐤
xsy	퐥
xsf	퐦
xsv	퐧
xsl	퐨
xsk	퐩
xsg	퐪
xsc	퐫
xss	퐬
xsj	퐭
xsn	퐮
xsr	퐯
xsp	퐰
xst	퐱
xsi	퐲
xws	퐳
xso	퐴
xsa	퐵
xsh	퐶
xsb	퐷
xsm	퐸
xsq	퐹
xsu	퐺
xsd	퐻
xsz	퐼
xse	퐽
xsx	퐾
xsw	퐿
xx	푀
xxy	푁
xxf	푂
xxv	푃
xxl	푄
xxk	푅
xxg	푆
xxc	푇
xxs	푈
xxj	푉
xxn	푊
xxr	푋
xxp	푌
xxt	푍
xxi	푎
xwx	푏
xxo	푐
xxa	푑
xxh	푒
xxb	푓
xxm	푔
xxq	푕
xxu	푖
xxd	푗
xxz	푘
xxe	푙
xxx	푚
xxw	푛
xmf	푞
xmv	푟
xmk	푡
xmg	푢
xmj	푥
xmn	푦
xmr	푧
xmp	푨
xmt	푩
xmi	푪
xwm	푫
xmh	푮
xmm	푰
xtf	푺
xtv	푻
xtk	푽
xtg	푾
xtj	풁
xtn	풂
xtr	풃
xtp	풄
xtt	풅
xti	풆
xwt	풇
xth	풊
xtm	풌
xa	풔
xay	풕
xaf	풖
xav	풗
xal	풘
xak	풙
xag	풚
xac	풛
xas	풜
xaj	풝
xan	풞
xar	풟
xap	풠
xat	풡
xai	풢
xwa	풣
xao	풤
xaa	풥
xah	풦
xab	풧
xam	풨
xaq	풩
xau	풪
xad	풫
xaz	풬
xae	풭
xax	풮
xaw	풯
xz	풰
xzy	풱
xzf	풲
xzv	풳
xzl	풴
xzk	풵
xzg	풶
xzc	풷
xzs	풸
xzj	풹
xzn	풺
xzr	풻
xzp	풼
xzt	풽
xzi	풾
xwz	풿
xzo	퓀
xza	퓁
xzh	퓂
xzb	퓃
xzm	퓄
xzq	퓅
xzu	퓆
xzd	퓇
xzz	퓈
xze	퓉
xzx	퓊
xzw	퓋
xd	퓌
xdy	퓍
xdf	퓎
xdv	퓏
xdl	퓐
xdk	퓑
xdg	퓒
xdc	퓓
xds	퓔
xdj	퓕
xdn	퓖
xdr	퓗
xdp	퓘
xdt	퓙
xdi	퓚
xwd	퓛
xdo	퓜
xda	퓝
xdh	퓞
xdb	퓟
xdm	퓠
xdq	퓡
xdu	퓢
xdd	퓣
xdz	퓤
xde	퓥
xdx	퓦
xdw	퓧
xrf	퓪
xrv	퓫
xrk	퓭
xrg	퓮
xrj	퓱
xrn	퓲
xrr	퓳
xrp	퓴
xrt	퓵
xri	퓶
xwr	퓷
xrh	퓺
xrm	퓼
xvf	픆
xvv	픇
xvk	픉
xvg	픊
xvj	픍
xvn	픎
xvr	픏
xvp	픐
xvt	픑
xvi	픒
xwv	픓
xvh	픖
xvm	픘
xl	픠
xly	픡
xlf	픢
xlv	픣
xll	픤
xlk	픥
xlg	픦
xlc	픧
xls	픨
xlj	픩
xln	픪
xlr	픫
xlp	픬
xlt	픭
xli	픮
xwl	픯
xlo	픰
xla	픱
xlh	픲
xlb	픳
xlm	픴
xlq	픵
xlu	픶
xld	픷
xlz	픸
xle	픹
xlx	픺
xlw	픻
xif	픾
xiv	픿
xik	핁
xig	핂
xij	핅
xin	핆
xir	핇
xip	핈
xit	핉
xii	핊
xwi	핋
xih	핎
xim	핐
#s19
wkf	핚
wkv	핛
wkk	핝
wkg	핞
wkj	핡
wkn	핢
wkr	핣
wkp	핤
wkt	핥
wki	핦
wwk	핧
wkh	핪
wkm	핬
whf	핶
whv	핷
whk	핹
whg	핺
whj	핽
whn	핾
whr	핿
whp	햀
wht	햁
whi	햂
wwh	햃
whh	햆
whm	했
wff	햒
wfv	햓
wfk	햕
wfg	햖
wfj	햙
wfn	햚
wfr	햛
wfp	햜
wft	햝
wfi	햞
wwf	햟
wfh	햢
wfm	햤
wo	햬
woy	햭
wof	햮
wov	햯
wol	햰
wok	햱
wog	햲
woc	햳
wos	햴
woj	햵
won	햶
wor	햷
wop	햸
wot	햹
woi	햺
wwo	햻
woo	햼
woa	햽
woh	햾
wob	햿
wom	헀
woq	헁
wou	헂
wod	헃
woz	헄
woe	헅
wox	헆
wow	헇
wjf	헊
wjv	헋
wjk	헍
wjg	헎
wjj	헑
wjn	헒
wjr	헓
wjp	헔
wjt	헕
wji	헖
wwj	헗
wjh	헚
wjm	헜
wpf	헦
wpv	헧
wpk	헩
wpg	헪
wpj	헭
wpn	헮
wpr	헯
wpp	헰
wpt	헱
wpi	헲
wwp	헳
wph	헶
wpm	헸
wgf	혂
wgv	혃
wgk	혅
wgg	혆
wgj	혉
wgn	혊
wgr	혋
wgp	혌
wgt	혍
wgi	혎
wwg	혏
wgh	혒
wgm	혔
wq	혜
wqy	혝
wqf	혞
wqv	혟
wql	혠
wqk	혡
wqg	혢
wqc	혣
wqs	혤
wqj	혥
wqn	혦
wqr	혧
wqp	혨
wqt	혩
wqi	혪
wwq	혫
wqo	혬
wqa	혭
wqh	혮
wqb	혯
wqm	혰
wqq	혱
wqu	혲
wqd	혳
wqz	혴
wqe	혵
wqx	혶
wqw	혷
wnf	혺
wnv	혻
wnk	혽
wng	혾
wnj	홁
wnn	홂
wnr	홃
wnp	홄
wnt	홅
wni	홆
wwn	홇
wnh	홊
wnm	홌
we	화
wey	확
wef	홖
wev	홗
wel	환
wek	홙
weg	홚
wec	홛
wes	활
wej	홝
wen	홞
wer	홟
wep	홠
wet	홡
wei	홢
wwe	홣
weo	홤
wea	홥
weh	홦
web	홧
wem	홨
weq	황
weu	홪
wed	홫
wez	홬
wee	홭
wex	홮
wew	홯
ws	홰
wsy	홱
wsf	홲
wsv	홳
wsl	홴
wsk	홵
wsg	홶
wsc	홷
wss	홸
wsj	홹
wsn	홺
wsr	홻
wsp	홼
wst	홽
wsi	홾
wws	홿
wso	횀
wsa	횁
wsh	횂
wsb	횃
wsm	횄
wsq	횅
wsu	횆
wsd	횇
wsz	횈
wse	횉
wsx	횊
wsw	횋
wx	회
wxy	획
wxf	횎
wxv	횏
wxl	횐
wxk	횑
wxg	횒
wxc	횓
wxs	횔
wxj	횕
wxn	횖
wxr	횗
wxp	횘
wxt	횙
wxi	횚
wwx	횛
wxo	횜
wxa	횝
wxh	횞
wxb	횟
wxm	횠
wxq	횡
wxu	횢
wxd	횣
wxz	횤
wxe	횥
wxx	횦
wxw	횧
wmf	횪
wmv	횫
wmk	횭
wmg	횮
wmj	횱
wmn	횲
wmr	횳
wmp	횴
wmt	횵
wmi	횶
wwm	횷
wmh	횺
wmm	횼
wtf	훆
wtv	훇
wtk	훉
wtg	훊
wtj	훍
wtn	훎
wtr	훏
wtp	훐
wtt	훑
wti	훒
wwt	훓
wth	훖
wtm	훘
wa	훠
way	훡
waf	훢
wav	훣
wal	훤
wak	훥
wag	훦
wac	훧
was	훨
waj	훩
wan	훪
war	훫
wap	훬
wat	훭
wai	훮
wwa	훯
wao	훰
waa	훱
wah	훲
wab	훳
wam	훴
waq	훵
wau	훶
wad	훷
waz	훸
wae	훹
wax	훺
waw	훻
wz	훼
wzy	훽
wzf	훾
wzv	훿
wzl	휀
wzk	휁
wzg	휂
wzc	휃
wzs	휄
wzj	휅
wzn	휆
wzr	휇
wzp	휈
wzt	휉
wzi	휊
wwz	휋
wzo	휌
wza	휍
wzh	휎
wzb	휏
wzm	휐
wzq	휑
wzu	휒
wzd	휓
wzz	휔
wze	휕
wzx	휖
wzw	휗
wd	휘
wdy	휙
wdf	휚
wdv	휛
wdl	휜
wdk	휝
wdg	휞
wdc	휟
wds	휠
wdj	휡
wdn	휢
wdr	휣
wdp	휤
wdt	휥
wdi	휦
wwd	휧
wdo	휨
wda	휩
wdh	휪
wdb	휫
wdm	휬
wdq	휭
wdu	휮
wdd	휯
wdz	휰
wde	휱
wdx	휲
wdw	휳
wrf	휶
wrv	휷
wrk	휹
wrg	휺
wrj	휽
wrn	휾
wrr	휿
wrp	흀
wrt	흁
wri	흂
wwr	흃
wrh	흆
wrm	흈
wvf	흒
wvv	흓
wvk	흕
wvg	흖
wvj	흙
wvn	흚
wvr	흛
wvp	흜
wvt	흝
wvi	흞
wwv	흟
wvh	흢
wvm	흤
wl	희
wly	흭
wlf	흮
wlv	흯
wll	흰
wlk	흱
wlg	흲
wlc	흳
wls	흴
wlj	흵
wln	흶
wlr	흷
wlp	흸
wlt	흹
wli	흺
wwl	흻
wlo	흼
wla	흽
wlh	흾
wlb	흿
wlm	힀
wlq	힁
wlu	힂
wld	힃
wlz	힄
wle	힅
wlx	힆
wlw	힇
wif	힊
wiv	힋
wik	힍
wig	힎
wij	힑
win	힒
wir	힓
wip	힔
wit	힕
wii	힖
wwi	힗
wih	힚
wim	힜
#諺文使用簡根結束
#諺文正碼啟始
yk	가
yky	각
ykyy	갂
ykyb	갃
ykl	간
yklu	갅
yklw	갆
ykc	갇
yks	갈
yksy	갉
ykso	갊
yksa	갋
yksb	갌
ykse	갍
yksx	갎
yksw	갏
yko	감
yka	갑
ykab	값
ykb	갓
ykbb	갔
ykq	강
yku	갖
ykd	갗
ykz	갘
yke	같
ykx	갚
ykw	갛
yh	개
yhy	객
yhyy	갞
yhyb	갟
yhl	갠
yhlu	갡
yhlw	갢
yhc	갣
yhs	갤
yhsy	갥
yhso	갦
yhsa	갧
yhsb	갨
yhse	갩
yhsx	갪
yhsw	갫
yho	갬
yha	갭
yhab	갮
yhb	갯
yhbb	갰
yhq	갱
yhu	갲
yhd	갳
yhz	갴
yhe	갵
yhx	갶
yhw	갷
yf	갸
yfy	갹
yfyy	갺
yfyb	갻
yfl	갼
yflu	갽
yflw	갾
yfc	갿
yfs	걀
yfsy	걁
yfso	걂
yfsa	걃
yfsb	걄
yfse	걅
yfsx	걆
yfsw	걇
yfo	걈
yfa	걉
yfab	걊
yfb	걋
yfbb	걌
yfq	걍
yfu	걎
yfd	걏
yfz	걐
yfe	걑
yfx	걒
yfw	걓
yhh	걔
yhhy	걕
yhhyy	걖
yhhyb	걗
yhhl	걘
yhhlu	걙
yhhlw	걚
yhhc	걛
yhhs	걜
yhhsy	걝
yhhso	걞
yhhsa	걟
yhhsb	걠
yhhse	걡
yhhsx	걢
yhhsw	걣
yhho	걤
yhha	걥
yhhab	걦
yhhb	걧
yhhbb	걨
yhhq	걩
yhhu	걪
yhhd	걫
yhhz	걬
yhhe	걭
yhhx	걮
yhhw	걯
yj	거
yjy	걱
yjyy	걲
yjyb	걳
yjl	건
yjlu	걵
yjlw	걶
yjc	걷
yjs	걸
yjsy	걹
yjso	걺
yjsa	걻
yjsb	걼
yjse	걽
yjsx	걾
yjsw	걿
yjo	검
yja	겁
yjab	겂
yjb	것
yjbb	겄
yjq	겅
yju	겆
yjd	겇
yjz	겈
yje	겉
yjx	겊
yjw	겋
yp	게
ypy	겍
ypyy	겎
ypyb	겏
ypl	겐
yplu	겑
yplw	겒
ypc	겓
yps	겔
ypsy	겕
ypso	겖
ypsa	겗
ypsb	겘
ypse	겙
ypsx	겚
ypsw	겛
ypo	겜
ypa	겝
ypab	겞
ypb	겟
ypbb	겠
ypq	겡
ypu	겢
ypd	겣
ypz	겤
ype	겥
ypx	겦
ypw	겧
yg	겨
ygy	격
ygyy	겪
ygyb	겫
ygl	견
yglu	겭
yglw	겮
ygc	겯
ygs	결
ygsy	겱
ygso	겲
ygsa	겳
ygsb	겴
ygse	겵
ygsx	겶
ygsw	겷
ygo	겸
yga	겹
ygab	겺
ygb	겻
ygbb	겼
ygq	경
ygu	겾
ygd	겿
ygz	곀
yge	곁
ygx	곂
ygw	곃
ypp	계
yppy	곅
yppyy	곆
yppyb	곇
yppl	곈
ypplu	곉
ypplw	곊
yppc	곋
ypps	곌
yppsy	곍
yppso	곎
yppsa	곏
yppsb	곐
yppse	곑
yppsx	곒
yppsw	곓
yppo	곔
yppa	곕
yppab	곖
yppb	곗
yppbb	곘
yppq	곙
yppu	곚
yppd	곛
yppz	곜
yppe	곝
yppx	곞
yppw	곟
yn	고
yny	곡
ynyy	곢
ynyb	곣
ynl	곤
ynlu	곥
ynlw	곦
ync	곧
yns	골
ynsy	곩
ynso	곪
ynsa	곫
ynsb	곬
ynse	곭
ynsx	곮
ynsw	곯
yno	곰
yna	곱
ynab	곲
ynb	곳
ynbb	곴
ynq	공
ynu	곶
ynd	곷
ynz	곸
yne	곹
ynx	곺
ynw	곻
ynk	과
ynky	곽
ynkyy	곾
ynkyb	곿
#3
ynkl	관
ynklu	괁
ynklw	괂
ynkc	괃
ynks	괄
ynksy	괅
ynkso	괆
ynksa	괇
ynksb	괈
ynkse	괉
ynksx	괊
ynksw	괋
ynko	괌
ynka	괍
ynkab	괎
ynkb	괏
ynkbb	괐
ynkq	광
ynku	괒
ynkd	괓
ynkz	괔
ynke	괕
ynkx	괖
ynkw	괗
ynh	괘
ynhy	괙
ynhyy	괚
ynhyb	괛
ynhl	괜
ynhlu	괝
ynhlw	괞
ynhc	괟
ynhs	괠
ynhsy	괡
ynhso	괢
ynhsa	괣
ynhsb	괤
ynhse	괥
ynhsx	괦
ynhsw	괧
ynho	괨
ynha	괩
ynhab	괪
ynhb	괫
ynhbb	괬
ynhq	괭
ynhu	괮
ynhd	괯
ynhz	괰
ynhe	괱
ynhx	괲
ynhw	괳
yni	괴
yniy	괵
yniyy	괶
yniyb	괷
ynil	괸
ynilu	괹
ynilw	괺
ynic	괻
ynis	괼
ynisy	괽
yniso	괾
ynisa	괿
ynisb	굀
ynise	굁
ynisx	굂
ynisw	굃
ynio	굄
ynia	굅
yniab	굆
ynib	굇
ynibb	굈
yniq	굉
yniu	굊
ynid	굋
yniz	굌
ynie	굍
ynix	굎
yniw	굏
ym	교
ymy	굑
ymyy	굒
ymyb	굓
yml	굔
ymlu	굕
ymlw	굖
ymc	굗
yms	굘
ymsy	굙
ymso	굚
ymsa	굛
ymsb	굜
ymse	굝
ymsx	굞
ymsw	굟
ymo	굠
yma	굡
ymab	굢
ymb	굣
ymbb	굤
ymq	굥
ymu	굦
ymd	굧
ymz	굨
yme	굩
ymx	굪
ymw	굫
yt	구
yty	국
ytyy	굮
ytyb	굯
ytl	군
ytlu	굱
ytlw	굲
ytc	굳
yts	굴
ytsy	굵
ytso	굶
ytsa	굷
ytsb	굸
ytse	굹
ytsx	굺
ytsw	굻
yto	굼
yta	굽
ytab	굾
ytb	굿
ytbb	궀
ytq	궁
ytu	궂
ytd	궃
ytz	궄
yte	궅
ytx	궆
ytw	궇
ytj	궈
ytjy	궉
ytjyy	궊
ytjyb	궋
ytjl	권
ytjlu	궍
ytjlw	궎
ytjc	궏
ytjs	궐
ytjsy	궑
ytjso	궒
ytjsa	궓
ytjsb	궔
ytjse	궕
ytjsx	궖
ytjsw	궗
ytjo	궘
ytja	궙
ytjab	궚
ytjb	궛
ytjbb	궜
ytjq	궝
ytju	궞
ytjd	궟
ytjz	궠
ytje	궡
ytjx	궢
ytjw	궣
ytp	궤
ytpy	궥
ytpyy	궦
ytpyb	궧
ytpl	궨
ytplu	궩
ytplw	궪
ytpc	궫
ytps	궬
ytpsy	궭
ytpso	궮
ytpsa	궯
ytpsb	궰
ytpse	궱
ytpsx	궲
ytpsw	궳
ytpo	궴
ytpa	궵
ytpab	궶
ytpb	궷
ytpbb	궸
ytpq	궹
ytpu	궺
ytpd	궻
ytpz	궼
ytpe	궽
ytpx	궾
ytpw	궿
yti	귀
ytiy	귁
ytiyy	귂
ytiyb	귃
ytil	귄
ytilu	귅
ytilw	귆
ytic	귇
ytis	귈
ytisy	귉
ytiso	귊
ytisa	귋
ytisb	귌
ytise	귍
ytisx	귎
ytisw	귏
ytio	귐
ytia	귑
ytiab	귒
ytib	귓
ytibb	귔
ytiq	귕
ytiu	귖
ytid	귗
ytiz	귘
ytie	귙
ytix	귚
ytiw	귛
yr	규
yry	귝
yryy	귞
yryb	귟
yrl	균
yrlu	귡
yrlw	귢
yrc	귣
yrs	귤
yrsy	귥
yrso	귦
yrsa	귧
yrsb	귨
yrse	귩
yrsx	귪
yrsw	귫
yro	귬
yra	귭
yrab	귮
yrb	귯
yrbb	귰
yrq	귱
yru	귲
yrd	귳
yrz	귴
yre	귵
yrx	귶
yrw	귷
yv	그
yvy	극
yvyy	귺
yvyb	귻
yvl	근
yvlu	귽
yvlw	귾
yvc	귿
#4
yvs	글
yvsy	긁
yvso	긂
yvsa	긃
yvsb	긄
yvse	긅
yvsx	긆
yvsw	긇
yvo	금
yva	급
yvab	긊
yvb	긋
yvbb	긌
yvq	긍
yvu	긎
yvd	긏
yvz	긐
yve	긑
yvx	긒
yvw	긓
yvi	긔
yviy	긕
yviyy	긖
yviyb	긗
yvil	긘
yvilu	긙
yvilw	긚
yvic	긛
yvis	긜
yvisy	긝
yviso	긞
yvisa	긟
yvisb	긠
yvise	긡
yvisx	긢
yvisw	긣
yvio	긤
yvia	긥
yviab	긦
yvib	긧
yvibb	긨
yviq	긩
yviu	긪
yvid	긫
yviz	긬
yvie	긭
yvix	긮
yviw	긯
yi	기
yiy	긱
yiyy	긲
yiyb	긳
yil	긴
yilu	긵
yilw	긶
yic	긷
yis	길
yisy	긹
yiso	긺
yisa	긻
yisb	긼
yise	긽
yisx	긾
yisw	긿
yio	김
yia	깁
yiab	깂
yib	깃
yibb	깄
yiq	깅
yiu	깆
yid	깇
yiz	깈
yie	깉
yix	깊
yiw	깋
yyk	까
yyky	깍
yykyy	깎
yykyb	깏
yykl	깐
yyklu	깑
yyklw	깒
yykc	깓
yyks	깔
yyksy	깕
yykso	깖
yyksa	깗
yyksb	깘
yykse	깙
yyksx	깚
yyksw	깛
yyko	깜
yyka	깝
yykab	깞
yykb	깟
yykbb	깠
yykq	깡
yyku	깢
yykd	깣
yykz	깤
yyke	깥
yykx	깦
yykw	깧
yyh	깨
yyhy	깩
yyhyy	깪
yyhyb	깫
yyhl	깬
yyhlu	깭
yyhlw	깮
yyhc	깯
yyhs	깰
yyhsy	깱
yyhso	깲
yyhsa	깳
yyhsb	깴
yyhse	깵
yyhsx	깶
yyhsw	깷
yyho	깸
yyha	깹
yyhab	깺
yyhb	깻
yyhbb	깼
yyhq	깽
yyhu	깾
yyhd	깿
yyhz	꺀
yyhe	꺁
yyhx	꺂
yyhw	꺃
yyf	꺄
yyfy	꺅
yyfyy	꺆
yyfyb	꺇
yyfl	꺈
yyflu	꺉
yyflw	꺊
yyfc	꺋
yyfs	꺌
yyfsy	꺍
yyfso	꺎
yyfsa	꺏
yyfsb	꺐
yyfse	꺑
yyfsx	꺒
yyfsw	꺓
yyfo	꺔
yyfa	꺕
yyfab	꺖
yyfb	꺗
yyfbb	꺘
yyfq	꺙
yyfu	꺚
yyfd	꺛
yyfz	꺜
yyfe	꺝
yyfx	꺞
yyfw	꺟
vyh	꺠
vyhy	꺡
vyhyy	꺢
vyhyb	꺣
vyhl	꺤
vyhlu	꺥
vyhlw	꺦
vyhc	꺧
vyhs	꺨
vyhsy	꺩
vyhso	꺪
vyhsa	꺫
vyhsb	꺬
vyhse	꺭
vyhsx	꺮
vyhsw	꺯
vyho	꺰
vyha	꺱
vyhab	꺲
vyhb	꺳
vyhbb	꺴
vyhq	꺵
vyhu	꺶
vyhd	꺷
vyhz	꺸
vyhe	꺹
vyhx	꺺
vyhw	꺻
yyj	꺼
yyjy	꺽
yyjyy	꺾
yyjyb	꺿
yyjl	껀
yyjlu	껁
yyjlw	껂
yyjc	껃
yyjs	껄
yyjsy	껅
yyjso	껆
yyjsa	껇
yyjsb	껈
yyjse	껉
yyjsx	껊
yyjsw	껋
yyjo	껌
yyja	껍
yyjab	껎
yyjb	껏
yyjbb	껐
yyjq	껑
yyju	껒
yyjd	껓
yyjz	껔
yyje	껕
yyjx	껖
yyjw	껗
yyp	께
yypy	껙
yypyy	껚
yypyb	껛
yypl	껜
yyplu	껝
yyplw	껞
yypc	껟
yyps	껠
yypsy	껡
yypso	껢
yypsa	껣
yypsb	껤
yypse	껥
yypsx	껦
yypsw	껧
yypo	껨
yypa	껩
yypab	껪
yypb	껫
yypbb	껬
yypq	껭
yypu	껮
yypd	껯
yypz	껰
yype	껱
yypx	껲
yypw	껳
yyg	껴
yygy	껵
yygyy	껶
yygyb	껷
yygl	껸
yyglu	껹
yyglw	껺
yygc	껻
yygs	껼
yygsy	껽
yygso	껾
yygsa	껿
#5
yygsb	꼀
yygse	꼁
yygsx	꼂
yygsw	꼃
yygo	꼄
yyga	꼅
yygab	꼆
yygb	꼇
yygbb	꼈
yygq	꼉
yygu	꼊
yygd	꼋
yygz	꼌
yyge	꼍
yygx	꼎
yygw	꼏
vyp	꼐
vypy	꼑
vypyy	꼒
vypyb	꼓
vypl	꼔
vyplu	꼕
vyplw	꼖
vypc	꼗
vyps	꼘
vypsy	꼙
vypso	꼚
vypsa	꼛
vypsb	꼜
vypse	꼝
vypsx	꼞
vypsw	꼟
vypo	꼠
vypa	꼡
vypab	꼢
vypb	꼣
vypbb	꼤
vypq	꼥
vypu	꼦
vypd	꼧
vypz	꼨
vype	꼩
vypx	꼪
vypw	꼫
yyn	꼬
yyny	꼭
yynyy	꼮
yynyb	꼯
yynl	꼰
yynlu	꼱
yynlw	꼲
yync	꼳
yyns	꼴
yynsy	꼵
yynso	꼶
yynsa	꼷
yynsb	꼸
yynse	꼹
yynsx	꼺
yynsw	꼻
yyno	꼼
yyna	꼽
yynab	꼾
yynb	꼿
yynbb	꽀
yynq	꽁
yynu	꽂
yynd	꽃
yynz	꽄
yyne	꽅
yynx	꽆
yynw	꽇
yynk	꽈
yynky	꽉
yynkyy	꽊
yynkyb	꽋
yynkl	꽌
yynklu	꽍
yynklw	꽎
yynkc	꽏
yynks	꽐
yynksy	꽑
yynkso	꽒
yynksa	꽓
yynksb	꽔
yynkse	꽕
yynksx	꽖
yynksw	꽗
yynko	꽘
yynka	꽙
yynkab	꽚
yynkb	꽛
yynkbb	꽜
yynkq	꽝
yynku	꽞
yynkd	꽟
yynkz	꽠
yynke	꽡
yynkx	꽢
yynkw	꽣
yynh	꽤
yynhy	꽥
yynhyy	꽦
yynhyb	꽧
yynhl	꽨
yynhlu	꽩
yynhlw	꽪
yynhc	꽫
yynhs	꽬
yynhsy	꽭
yynhso	꽮
yynhsa	꽯
yynhsb	꽰
yynhse	꽱
yynhsx	꽲
yynhsw	꽳
yynho	꽴
yynha	꽵
yynhab	꽶
yynhb	꽷
yynhbb	꽸
yynhq	꽹
yynhu	꽺
yynhd	꽻
yynhz	꽼
yynhe	꽽
yynhx	꽾
yynhw	꽿
yyni	꾀
yyniy	꾁
yyniyy	꾂
yyniyb	꾃
yynil	꾄
yynilu	꾅
yynilw	꾆
yynic	꾇
yynis	꾈
yynisy	꾉
yyniso	꾊
yynisa	꾋
yynisb	꾌
yynise	꾍
yynisx	꾎
yynisw	꾏
yynio	꾐
yynia	꾑
yyniab	꾒
yynib	꾓
yynibb	꾔
yyniq	꾕
yyniu	꾖
yynid	꾗
yyniz	꾘
yynie	꾙
yynix	꾚
yyniw	꾛
yym	꾜
yymy	꾝
yymyy	꾞
yymyb	꾟
yyml	꾠
yymlu	꾡
yymlw	꾢
yymc	꾣
yyms	꾤
yymsy	꾥
yymso	꾦
yymsa	꾧
yymsb	꾨
yymse	꾩
yymsx	꾪
yymsw	꾫
yymo	꾬
yyma	꾭
yymab	꾮
yymb	꾯
yymbb	꾰
yymq	꾱
yymu	꾲
yymd	꾳
yymz	꾴
yyme	꾵
yymx	꾶
yymw	꾷
yyt	꾸
yyty	꾹
yytyy	꾺
yytyb	꾻
yytl	꾼
yytlu	꾽
yytlw	꾾
yytc	꾿
yyts	꿀
yytsy	꿁
yytso	꿂
yytsa	꿃
yytsb	꿄
yytse	꿅
yytsx	꿆
yytsw	꿇
yyto	꿈
yyta	꿉
yytab	꿊
yytb	꿋
yytbb	꿌
yytq	꿍
yytu	꿎
yytd	꿏
yytz	꿐
yyte	꿑
yytx	꿒
yytw	꿓
yytj	꿔
yytjy	꿕
yytjyy	꿖
yytjyb	꿗
yytjl	꿘
yytjlu	꿙
yytjlw	꿚
yytjc	꿛
yytjs	꿜
yytjsy	꿝
yytjso	꿞
yytjsa	꿟
yytjsb	꿠
yytjse	꿡
yytjsx	꿢
yytjsw	꿣
yytjo	꿤
yytja	꿥
yytjab	꿦
yytjb	꿧
yytjbb	꿨
yytjq	꿩
yytju	꿪
yytjd	꿫
yytjz	꿬
yytje	꿭
yytjx	꿮
yytjw	꿯
yytp	꿰
yytpy	꿱
yytpyy	꿲
yytpyb	꿳
yytpl	꿴
yytplu	꿵
yytplw	꿶
yytpc	꿷
yytps	꿸
yytpsy	꿹
yytpso	꿺
yytpsa	꿻
yytpsb	꿼
yytpse	꿽
yytpsx	꿾
yytpsw	꿿
#6
yytpo	뀀
yytpa	뀁
yytpab	뀂
yytpb	뀃
yytpbb	뀄
yytpq	뀅
yytpu	뀆
yytpd	뀇
yytpz	뀈
yytpe	뀉
yytpx	뀊
yytpw	뀋
yyti	뀌
yytiy	뀍
yytiyy	뀎
yytiyb	뀏
yytil	뀐
yytilu	뀑
yytilw	뀒
yytic	뀓
yytis	뀔
yytisy	뀕
yytiso	뀖
yytisa	뀗
yytisb	뀘
yytise	뀙
yytisx	뀚
yytisw	뀛
yytio	뀜
yytia	뀝
yytiab	뀞
yytib	뀟
yytibb	뀠
yytiq	뀡
yytiu	뀢
yytid	뀣
yytiz	뀤
yytie	뀥
yytix	뀦
yytiw	뀧
yyr	뀨
yyry	뀩
yyryy	뀪
yyryb	뀫
yyrl	뀬
yyrlu	뀭
yyrlw	뀮
yyrc	뀯
yyrs	뀰
yyrsy	뀱
yyrso	뀲
yyrsa	뀳
yyrsb	뀴
yyrse	뀵
yyrsx	뀶
yyrsw	뀷
yyro	뀸
yyra	뀹
yyrab	뀺
yyrb	뀻
yyrbb	뀼
yyrq	뀽
yyru	뀾
yyrd	뀿
yyrz	끀
yyre	끁
yyrx	끂
yyrw	끃
yyv	끄
yyvy	끅
yyvyy	끆
yyvyb	끇
yyvl	끈
yyvlu	끉
yyvlw	끊
yyvc	끋
yyvs	끌
yyvsy	끍
yyvso	끎
yyvsa	끏
yyvsb	끐
yyvse	끑
yyvsx	끒
yyvsw	끓
yyvo	끔
yyva	끕
yyvab	끖
yyvb	끗
yyvbb	끘
yyvq	끙
yyvu	끚
yyvd	끛
yyvz	끜
yyve	끝
yyvx	끞
yyvw	끟
yyvi	끠
yyviy	끡
yyviyy	끢
yyviyb	끣
yyvil	끤
yyvilu	끥
yyvilw	끦
yyvic	끧
yyvis	끨
yyvisy	끩
yyviso	끪
yyvisa	끫
yyvisb	끬
yyvise	끭
yyvisx	끮
yyvisw	끯
yyvio	끰
yyvia	끱
yyviab	끲
yyvib	끳
yyvibb	끴
yyviq	끵
yyviu	끶
yyvid	끷
yyviz	끸
yyvie	끹
yyvix	끺
yyviw	끻
yyi	끼
yyiy	끽
yyiyy	끾
yyiyb	끿
yyil	낀
yyilu	낁
yyilw	낂
yyic	낃
yyis	낄
yyisy	낅
yyiso	낆
yyisa	낇
yyisb	낈
yyise	낉
yyisx	낊
yyisw	낋
yyio	낌
yyia	낍
yyiab	낎
yyib	낏
yyibb	낐
yyiq	낑
yyiu	낒
yyid	낓
yyiz	낔
yyie	낕
yyix	낖
yyiw	낗
lk	나
lky	낙
lkyy	낚
lkyb	낛
lkl	난
lklu	낝
lklw	낞
lkc	낟
lks	날
lksy	낡
lkso	낢
lksa	낣
lksb	낤
lkse	낥
lksx	낦
lksw	낧
lko	남
lka	납
lkab	낪
lkb	낫
lkbb	났
lkq	낭
lku	낮
lkd	낯
lkz	낰
lke	낱
lkx	낲
lkw	낳
lh	내
lhy	낵
lhyy	낶
lhyb	낷
lhl	낸
lhlu	낹
lhlw	낺
lhc	낻
lhs	낼
lhsy	낽
lhso	낾
lhsa	낿
lhsb	냀
lhse	냁
lhsx	냂
lhsw	냃
lho	냄
lha	냅
lhab	냆
lhb	냇
lhbb	냈
lhq	냉
lhu	냊
lhd	냋
lhz	냌
lhe	냍
lhx	냎
lhw	냏
lf	냐
lfy	냑
lfyy	냒
lfyb	냓
lfl	냔
lflu	냕
lflw	냖
lfc	냗
lfs	냘
lfsy	냙
lfso	냚
lfsa	냛
lfsb	냜
lfse	냝
lfsx	냞
lfsw	냟
lfo	냠
lfa	냡
lfab	냢
lfb	냣
lfbb	냤
lfq	냥
lfu	냦
lfd	냧
lfz	냨
lfe	냩
lfx	냪
lfw	냫
lhh	냬
lhhy	냭
lhhyy	냮
lhhyb	냯
lhhl	냰
lhhlu	냱
lhhlw	냲
lhhc	냳
lhhs	냴
lhhsy	냵
lhhso	냶
lhhsa	냷
lhhsb	냸
lhhse	냹
lhhsx	냺
lhhsw	냻
lhho	냼
lhha	냽
lhhab	냾
lhhb	냿
#7
lhhbb	넀
lhhq	넁
lhhu	넂
lhhd	넃
lhhz	넄
lhhe	넅
lhhx	넆
lhhw	넇
lj	너
ljy	넉
ljyy	넊
ljyb	넋
ljl	넌
ljlu	넍
ljlw	넎
ljc	넏
ljs	널
ljsy	넑
ljso	넒
ljsa	넓
ljsb	넔
ljse	넕
ljsx	넖
ljsw	넗
ljo	넘
lja	넙
ljab	넚
ljb	넛
ljbb	넜
ljq	넝
lju	넞
ljd	넟
ljz	넠
lje	넡
ljx	넢
ljw	넣
lp	네
lpy	넥
lpyy	넦
lpyb	넧
lpl	넨
lplu	넩
lplw	넪
lpc	넫
lps	넬
lpsy	넭
lpso	넮
lpsa	넯
lpsb	넰
lpse	넱
lpsx	넲
lpsw	넳
lpo	넴
lpa	넵
lpab	넶
lpb	넷
lpbb	넸
lpq	넹
lpu	넺
lpd	넻
lpz	넼
lpe	넽
lpx	넾
lpw	넿
lg	녀
lgy	녁
lgyy	녂
lgyb	녃
lgl	년
lglu	녅
lglw	녆
lgc	녇
lgs	녈
lgsy	녉
lgso	녊
lgsa	녋
lgsb	녌
lgse	녍
lgsx	녎
lgsw	녏
lgo	념
lga	녑
lgab	녒
lgb	녓
lgbb	녔
lgq	녕
lgu	녖
lgd	녗
lgz	녘
lge	녙
lgx	녚
lgw	녛
lpp	녜
lppy	녝
lppyy	녞
lppyb	녟
lppl	녠
lpplu	녡
lpplw	녢
lppc	녣
lpps	녤
lppsy	녥
lppso	녦
lppsa	녧
lppsb	녨
lppse	녩
lppsx	녪
lppsw	녫
lppo	녬
lppa	녭
lppab	녮
lppb	녯
lppbb	녰
lppq	녱
lppu	녲
lppd	녳
lppz	녴
lppe	녵
lppx	녶
lppw	녷
ln	노
lny	녹
lnyy	녺
lnyb	녻
lnl	논
lnlu	녽
lnlw	녾
lnc	녿
lns	놀
lnsy	놁
lnso	놂
lnsa	놃
lnsb	놄
lnse	놅
lnsx	놆
lnsw	놇
lno	놈
lna	놉
lnab	놊
lnb	놋
lnbb	놌
lnq	농
lnu	놎
lnd	놏
lnz	놐
lne	놑
lnx	높
lnw	놓
lnk	놔
lnky	놕
lnkyy	놖
lnkyb	놗
lnkl	놘
lnklu	놙
lnklw	놚
lnkc	놛
lnks	놜
lnksy	놝
lnkso	놞
lnksa	놟
lnksb	놠
lnkse	놡
lnksx	놢
lnksw	놣
lnko	놤
lnka	놥
lnkab	놦
lnkb	놧
lnkbb	놨
lnkq	놩
lnku	놪
lnkd	놫
lnkz	놬
lnke	놭
lnkx	놮
lnkw	놯
lnh	놰
lnhy	놱
lnhyy	놲
lnhyb	놳
lnhl	놴
lnhlu	놵
lnhlw	놶
lnhc	놷
lnhs	놸
lnhsy	놹
lnhso	놺
lnhsa	놻
lnhsb	놼
lnhse	놽
lnhsx	놾
lnhsw	놿
lnho	뇀
lnha	뇁
lnhab	뇂
lnhb	뇃
lnhbb	뇄
lnhq	뇅
lnhu	뇆
lnhd	뇇
lnhz	뇈
lnhe	뇉
lnhx	뇊
lnhw	뇋
lni	뇌
lniy	뇍
lniyy	뇎
lniyb	뇏
lnil	뇐
lnilu	뇑
lnilw	뇒
lnic	뇓
lnis	뇔
lnisy	뇕
lniso	뇖
lnisa	뇗
lnisb	뇘
lnise	뇙
lnisx	뇚
lnisw	뇛
lnio	뇜
lnia	뇝
lniab	뇞
lnib	뇟
lnibb	뇠
lniq	뇡
lniu	뇢
lnid	뇣
lniz	뇤
lnie	뇥
lnix	뇦
lniw	뇧
lm	뇨
lmy	뇩
lmyy	뇪
lmyb	뇫
lml	뇬
lmlu	뇭
lmlw	뇮
lmc	뇯
lms	뇰
lmsy	뇱
lmso	뇲
lmsa	뇳
lmsb	뇴
lmse	뇵
lmsx	뇶
lmsw	뇷
lmo	뇸
lma	뇹
lmab	뇺
lmb	뇻
lmbb	뇼
lmq	뇽
lmu	뇾
lmd	뇿
#8
lmz	눀
lme	눁
lmx	눂
lmw	눃
lt	누
lty	눅
ltyy	눆
ltyb	눇
ltl	눈
ltlu	눉
ltlw	눊
ltc	눋
lts	눌
ltsy	눍
ltso	눎
ltsa	눏
ltsb	눐
ltse	눑
ltsx	눒
ltsw	눓
lto	눔
lta	눕
ltab	눖
ltb	눗
ltbb	눘
ltq	눙
ltu	눚
ltd	눛
ltz	눜
lte	눝
ltx	눞
ltw	눟
ltj	눠
ltjy	눡
ltjyy	눢
ltjyb	눣
ltjl	눤
ltjlu	눥
ltjlw	눦
ltjc	눧
ltjs	눨
ltjsy	눩
ltjso	눪
ltjsa	눫
ltjsb	눬
ltjse	눭
ltjsx	눮
ltjsw	눯
ltjo	눰
ltja	눱
ltjab	눲
ltjb	눳
ltjbb	눴
ltjq	눵
ltju	눶
ltjd	눷
ltjz	눸
ltje	눹
ltjx	눺
ltjw	눻
ltp	눼
ltpy	눽
ltpyy	눾
ltpyb	눿
ltpl	뉀
ltplu	뉁
ltplw	뉂
ltpc	뉃
ltps	뉄
ltpsy	뉅
ltpso	뉆
ltpsa	뉇
ltpsb	뉈
ltpse	뉉
ltpsx	뉊
ltpsw	뉋
ltpo	뉌
ltpa	뉍
ltpab	뉎
ltpb	뉏
ltpbb	뉐
ltpq	뉑
ltpu	뉒
ltpd	뉓
ltpz	뉔
ltpe	뉕
ltpx	뉖
ltpw	뉗
lti	뉘
ltiy	뉙
ltiyy	뉚
ltiyb	뉛
ltil	뉜
ltilu	뉝
ltilw	뉞
ltic	뉟
ltis	뉠
ltisy	뉡
ltiso	뉢
ltisa	뉣
ltisb	뉤
ltise	뉥
ltisx	뉦
ltisw	뉧
ltio	뉨
ltia	뉩
ltiab	뉪
ltib	뉫
ltibb	뉬
ltiq	뉭
ltiu	뉮
ltid	뉯
ltiz	뉰
ltie	뉱
ltix	뉲
ltiw	뉳
lr	뉴
lry	뉵
lryy	뉶
lryb	뉷
lrl	뉸
lrlu	뉹
lrlw	뉺
lrc	뉻
lrs	뉼
lrsy	뉽
lrso	뉾
lrsa	뉿
lrsb	늀
lrse	늁
lrsx	늂
lrsw	늃
lro	늄
lra	늅
lrab	늆
lrb	늇
lrbb	늈
lrq	늉
lru	늊
lrd	늋
lrz	늌
lre	늍
lrx	늎
lrw	늏
lv	느
lvy	늑
lvyy	늒
lvyb	늓
lvl	는
lvlu	늕
lvlw	늖
lvc	늗
lvs	늘
lvsy	늙
lvso	늚
lvsa	늛
lvsb	늜
lvse	늝
lvsx	늞
lvsw	늟
lvo	늠
lva	늡
lvab	늢
lvb	늣
lvbb	늤
lvq	능
lvu	늦
lvd	늧
lvz	늨
lve	늩
lvx	늪
lvw	늫
lvi	늬
lviy	늭
lviyy	늮
lviyb	늯
lvil	늰
lvilu	늱
lvilw	늲
lvic	늳
lvis	늴
lvisy	늵
lviso	늶
lvisa	늷
lvisb	늸
lvise	늹
lvisx	늺
lvisw	늻
lvio	늼
lvia	늽
lviab	늾
lvib	늿
lvibb	닀
lviq	닁
lviu	닂
lvid	닃
lviz	닄
lvie	닅
lvix	닆
lviw	닇
li	니
liy	닉
liyy	닊
liyb	닋
lil	닌
lilu	닍
lilw	닎
lic	닏
lis	닐
lisy	닑
liso	닒
lisa	닓
lisb	닔
lise	닕
lisx	닖
lisw	닗
lio	님
lia	닙
liab	닚
lib	닛
libb	닜
liq	닝
liu	닞
lid	닟
liz	닠
lie	닡
lix	닢
liw	닣
ck	다
cky	닥
ckyy	닦
ckyb	닧
ckl	단
cklu	닩
cklw	닪
ckc	닫
cks	달
cksy	닭
ckso	닮
cksa	닯
cksb	닰
ckse	닱
cksx	닲
cksw	닳
cko	담
cka	답
ckab	닶
ckb	닷
ckbb	닸
ckq	당
cku	닺
ckd	닻
ckz	닼
cke	닽
ckx	닾
ckw	닿
#9
ch	대
chy	댁
chyy	댂
chyb	댃
chl	댄
chlu	댅
chlw	댆
chc	댇
chs	댈
chsy	댉
chso	댊
chsa	댋
chsb	댌
chse	댍
chsx	댎
chsw	댏
cho	댐
cha	댑
chab	댒
chb	댓
chbb	댔
chq	댕
chu	댖
chd	댗
chz	댘
che	댙
chx	댚
chw	댛
cf	댜
cfy	댝
cfyy	댞
cfyb	댟
cfl	댠
cflu	댡
cflw	댢
cfc	댣
cfs	댤
cfsy	댥
cfso	댦
cfsa	댧
cfsb	댨
cfse	댩
cfsx	댪
cfsw	댫
cfo	댬
cfa	댭
cfab	댮
cfb	댯
cfbb	댰
cfq	댱
cfu	댲
cfd	댳
cfz	댴
cfe	댵
cfx	댶
cfw	댷
chh	댸
chhy	댹
chhyy	댺
chhyb	댻
chhl	댼
chhlu	댽
chhlw	댾
chhc	댿
chhs	덀
chhsy	덁
chhso	덂
chhsa	덃
chhsb	덄
chhse	덅
chhsx	덆
chhsw	덇
chho	덈
chha	덉
chhab	덊
chhb	덋
chhbb	덌
chhq	덍
chhu	덎
chhd	덏
chhz	덐
chhe	덑
chhx	덒
chhw	덓
cj	더
cjy	덕
cjyy	덖
cjyb	덗
cjl	던
cjlu	덙
cjlw	덚
cjc	덛
cjs	덜
cjsy	덝
cjso	덞
cjsa	덟
cjsb	덠
cjse	덡
cjsx	덢
cjsw	덣
cjo	덤
cja	덥
cjab	덦
cjb	덧
cjbb	덨
cjq	덩
cju	덪
cjd	덫
cjz	덬
cje	덭
cjx	덮
cjw	덯
cp	데
cpy	덱
cpyy	덲
cpyb	덳
cpl	덴
cplu	덵
cplw	덶
cpc	덷
cps	델
cpsy	덹
cpso	덺
cpsa	덻
cpsb	덼
cpse	덽
cpsx	덾
cpsw	덿
cpo	뎀
cpa	뎁
cpab	뎂
cpb	뎃
cpbb	뎄
cpq	뎅
cpu	뎆
cpd	뎇
cpz	뎈
cpe	뎉
cpx	뎊
cpw	뎋
cg	뎌
cgy	뎍
cgyy	뎎
cgyb	뎏
cgl	뎐
cglu	뎑
cglw	뎒
cgc	뎓
cgs	뎔
cgsy	뎕
cgso	뎖
cgsa	뎗
cgsb	뎘
cgse	뎙
cgsx	뎚
cgsw	뎛
cgo	뎜
cga	뎝
cgab	뎞
cgb	뎟
cgbb	뎠
cgq	뎡
cgu	뎢
cgd	뎣
cgz	뎤
cge	뎥
cgx	뎦
cgw	뎧
cpp	뎨
cppy	뎩
cppyy	뎪
cppyb	뎫
cppl	뎬
cpplu	뎭
cpplw	뎮
cppc	뎯
cpps	뎰
cppsy	뎱
cppso	뎲
cppsa	뎳
cppsb	뎴
cppse	뎵
cppsx	뎶
cppsw	뎷
cppo	뎸
cppa	뎹
cppab	뎺
cppb	뎻
cppbb	뎼
cppq	뎽
cppu	뎾
cppd	뎿
cppz	돀
cppe	돁
cppx	돂
cppw	돃
cn	도
cny	독
cnyy	돆
cnyb	돇
cnl	돈
cnlu	돉
cnlw	돊
cnc	돋
cns	돌
cnsy	돍
cnso	돎
cnsa	돏
cnsb	돐
cnse	돑
cnsx	돒
cnsw	돓
cno	돔
cna	돕
cnab	돖
cnb	돗
cnbb	돘
cnq	동
cnu	돚
cnd	돛
cnz	돜
cne	돝
cnx	돞
cnw	돟
cnk	돠
cnky	돡
cnkyy	돢
cnkyb	돣
cnkl	돤
cnklu	돥
cnklw	돦
cnkc	돧
cnks	돨
cnksy	돩
cnkso	돪
cnksa	돫
cnksb	돬
cnkse	돭
cnksx	돮
cnksw	돯
cnko	돰
cnka	돱
cnkab	돲
cnkb	돳
cnkbb	돴
cnkq	돵
cnku	돶
cnkd	돷
cnkz	돸
cnke	돹
cnkx	돺
cnkw	돻
cnh	돼
cnhy	돽
cnhyy	돾
cnhyb	돿
#10
cnhl	됀
cnhlu	됁
cnhlw	됂
cnhc	됃
cnhs	됄
cnhsy	됅
cnhso	됆
cnhsa	됇
cnhsb	됈
cnhse	됉
cnhsx	됊
cnhsw	됋
cnho	됌
cnha	됍
cnhab	됎
cnhb	됏
cnhbb	됐
cnhq	됑
cnhu	됒
cnhd	됓
cnhz	됔
cnhe	됕
cnhx	됖
cnhw	됗
cni	되
cniy	됙
cniyy	됚
cniyb	됛
cnil	된
cnilu	됝
cnilw	됞
cnic	됟
cnis	될
cnisy	됡
cniso	됢
cnisa	됣
cnisb	됤
cnise	됥
cnisx	됦
cnisw	됧
cnio	됨
cnia	됩
cniab	됪
cnib	됫
cnibb	됬
cniq	됭
cniu	됮
cnid	됯
cniz	됰
cnie	됱
cnix	됲
cniw	됳
cm	됴
cmy	됵
cmyy	됶
cmyb	됷
cml	됸
cmlu	됹
cmlw	됺
cmc	됻
cms	됼
cmsy	됽
cmso	됾
cmsa	됿
cmsb	둀
cmse	둁
cmsx	둂
cmsw	둃
cmo	둄
cma	둅
cmab	둆
cmb	둇
cmbb	둈
cmq	둉
cmu	둊
cmd	둋
cmz	둌
cme	둍
cmx	둎
cmw	둏
ct	두
cty	둑
ctyy	둒
ctyb	둓
ctl	둔
ctlu	둕
ctlw	둖
ctc	둗
cts	둘
ctsy	둙
ctso	둚
ctsa	둛
ctsb	둜
ctse	둝
ctsx	둞
ctsw	둟
cto	둠
cta	둡
ctab	둢
ctb	둣
ctbb	둤
ctq	둥
ctu	둦
ctd	둧
ctz	둨
cte	둩
ctx	둪
ctw	둫
ctj	둬
ctjy	둭
ctjyy	둮
ctjyb	둯
ctjl	둰
ctjlu	둱
ctjlw	둲
ctjc	둳
ctjs	둴
ctjsy	둵
ctjso	둶
ctjsa	둷
ctjsb	둸
ctjse	둹
ctjsx	둺
ctjsw	둻
ctjo	둼
ctja	둽
ctjab	둾
ctjb	둿
ctjbb	뒀
ctjq	뒁
ctju	뒂
ctjd	뒃
ctjz	뒄
ctje	뒅
ctjx	뒆
ctjw	뒇
ctp	뒈
ctpy	뒉
ctpyy	뒊
ctpyb	뒋
ctpl	뒌
ctplu	뒍
ctplw	뒎
ctpc	뒏
ctps	뒐
ctpsy	뒑
ctpso	뒒
ctpsa	뒓
ctpsb	뒔
ctpse	뒕
ctpsx	뒖
ctpsw	뒗
ctpo	뒘
ctpa	뒙
ctpab	뒚
ctpb	뒛
ctpbb	뒜
ctpq	뒝
ctpu	뒞
ctpd	뒟
ctpz	뒠
ctpe	뒡
ctpx	뒢
ctpw	뒣
cti	뒤
ctiy	뒥
ctiyy	뒦
ctiyb	뒧
ctil	뒨
ctilu	뒩
ctilw	뒪
ctic	뒫
ctis	뒬
ctisy	뒭
ctiso	뒮
ctisa	뒯
ctisb	뒰
ctise	뒱
ctisx	뒲
ctisw	뒳
ctio	뒴
ctia	뒵
ctiab	뒶
ctib	뒷
ctibb	뒸
ctiq	뒹
ctiu	뒺
ctid	뒻
ctiz	뒼
ctie	뒽
ctix	뒾
ctiw	뒿
cr	듀
cry	듁
cryy	듂
cryb	듃
crl	듄
crlu	듅
crlw	듆
crc	듇
crs	듈
crsy	듉
crso	듊
crsa	듋
crsb	듌
crse	듍
crsx	듎
crsw	듏
cro	듐
cra	듑
crab	듒
crb	듓
crbb	듔
crq	듕
cru	듖
crd	듗
crz	듘
cre	듙
crx	듚
crw	듛
cv	드
cvy	득
cvyy	듞
cvyb	듟
cvl	든
cvlu	듡
cvlw	듢
cvc	듣
cvs	들
cvsy	듥
cvso	듦
cvsa	듧
cvsb	듨
cvse	듩
cvsx	듪
cvsw	듫
cvo	듬
cva	듭
cvab	듮
cvb	듯
cvbb	듰
cvq	등
cvu	듲
cvd	듳
cvz	듴
cve	듵
cvx	듶
cvw	듷
cvi	듸
cviy	듹
cviyy	듺
cviyb	듻
cvil	듼
cvilu	듽
cvilw	듾
cvic	듿
#11
cvis	딀
cvisy	딁
cviso	딂
cvisa	딃
cvisb	딄
cvise	딅
cvisx	딆
cvisw	딇
cvio	딈
cvia	딉
cviab	딊
cvib	딋
cvibb	딌
cviq	딍
cviu	딎
cvid	딏
cviz	딐
cvie	딑
cvix	딒
cviw	딓
ci	디
ciy	딕
ciyy	딖
ciyb	딗
cil	딘
cilu	딙
cilw	딚
cic	딛
cis	딜
cisy	딝
ciso	딞
cisa	딟
cisb	딠
cise	딡
cisx	딢
cisw	딣
cio	딤
cia	딥
ciab	딦
cib	딧
cibb	딨
ciq	딩
ciu	딪
cid	딫
ciz	딬
cie	딭
cix	딮
ciw	딯
cck	따
ccky	딱
cckyy	딲
cckyb	딳
cckl	딴
ccklu	딵
ccklw	딶
cckc	딷
ccks	딸
ccksy	딹
cckso	딺
ccksa	딻
ccksb	딼
cckse	딽
ccksx	딾
ccksw	딿
ccko	땀
ccka	땁
cckab	땂
cckb	땃
cckbb	땄
cckq	땅
ccku	땆
cckd	땇
cckz	땈
ccke	땉
cckx	땊
cckw	땋
cch	때
cchy	땍
cchyy	땎
cchyb	땏
cchl	땐
cchlu	땑
cchlw	땒
cchc	땓
cchs	땔
cchsy	땕
cchso	땖
cchsa	땗
cchsb	땘
cchse	땙
cchsx	땚
cchsw	땛
ccho	땜
ccha	땝
cchab	땞
cchb	땟
cchbb	땠
cchq	땡
cchu	땢
cchd	땣
cchz	땤
cche	땥
cchx	땦
cchw	땧
ccf	땨
ccfy	땩
ccfyy	땪
ccfyb	땫
ccfl	땬
ccflu	땭
ccflw	땮
ccfc	땯
ccfs	땰
ccfsy	땱
ccfso	땲
ccfsa	땳
ccfsb	땴
ccfse	땵
ccfsx	땶
ccfsw	땷
ccfo	땸
ccfa	땹
ccfab	땺
ccfb	땻
ccfbb	땼
ccfq	땽
ccfu	땾
ccfd	땿
ccfz	떀
ccfe	떁
ccfx	떂
ccfw	떃
vch	떄
vchy	떅
vchyy	떆
vchyb	떇
vchl	떈
vchlu	떉
vchlw	떊
vchc	떋
vchs	떌
vchsy	떍
vchso	떎
vchsa	떏
vchsb	떐
vchse	떑
vchsx	떒
vchsw	떓
vcho	떔
vcha	떕
vchab	떖
vchb	떗
vchbb	떘
vchq	떙
vchu	떚
vchd	떛
vchz	떜
vche	떝
vchx	떞
vchw	떟
ccj	떠
ccjy	떡
ccjyy	떢
ccjyb	떣
ccjl	떤
ccjlu	떥
ccjlw	떦
ccjc	떧
ccjs	떨
ccjsy	떩
ccjso	떪
ccjsa	떫
ccjsb	떬
ccjse	떭
ccjsx	떮
ccjsw	떯
ccjo	떰
ccja	떱
ccjab	떲
ccjb	떳
ccjbb	떴
ccjq	떵
ccju	떶
ccjd	떷
ccjz	떸
ccje	떹
ccjx	떺
ccjw	떻
ccp	떼
ccpy	떽
ccpyy	떾
ccpyb	떿
ccpl	뗀
ccplu	뗁
ccplw	뗂
ccpc	뗃
ccps	뗄
ccpsy	뗅
ccpso	뗆
ccpsa	뗇
ccpsb	뗈
ccpse	뗉
ccpsx	뗊
ccpsw	뗋
ccpo	뗌
ccpa	뗍
ccpab	뗎
ccpb	뗏
ccpbb	뗐
ccpq	뗑
ccpu	뗒
ccpd	뗓
ccpz	뗔
ccpe	뗕
ccpx	뗖
ccpw	뗗
ccg	뗘
ccgy	뗙
ccgyy	뗚
ccgyb	뗛
ccgl	뗜
ccglu	뗝
ccglw	뗞
ccgc	뗟
ccgs	뗠
ccgsy	뗡
ccgso	뗢
ccgsa	뗣
ccgsb	뗤
ccgse	뗥
ccgsx	뗦
ccgsw	뗧
ccgo	뗨
ccga	뗩
ccgab	뗪
ccgb	뗫
ccgbb	뗬
ccgq	뗭
ccgu	뗮
ccgd	뗯
ccgz	뗰
ccge	뗱
ccgx	뗲
ccgw	뗳
vcp	뗴
vcpy	뗵
vcpyy	뗶
vcpyb	뗷
vcpl	뗸
vcplu	뗹
vcplw	뗺
vcpc	뗻
vcps	뗼
vcpsy	뗽
vcpso	뗾
vcpsa	뗿
#12
vcpsb	똀
vcpse	똁
vcpsx	똂
vcpsw	똃
vcpo	똄
vcpa	똅
vcpab	똆
vcpb	똇
vcpbb	똈
vcpq	똉
vcpu	똊
vcpd	똋
vcpz	똌
vcpe	똍
vcpx	똎
vcpw	똏
ccn	또
ccny	똑
ccnyy	똒
ccnyb	똓
ccnl	똔
ccnlu	똕
ccnlw	똖
ccnc	똗
ccns	똘
ccnsy	똙
ccnso	똚
ccnsa	똛
ccnsb	똜
ccnse	똝
ccnsx	똞
ccnsw	똟
ccno	똠
ccna	똡
ccnab	똢
ccnb	똣
ccnbb	똤
ccnq	똥
ccnu	똦
ccnd	똧
ccnz	똨
ccne	똩
ccnx	똪
ccnw	똫
ccnk	똬
ccnky	똭
ccnkyy	똮
ccnkyb	똯
ccnkl	똰
ccnklu	똱
ccnklw	똲
ccnkc	똳
ccnks	똴
ccnksy	똵
ccnkso	똶
ccnksa	똷
ccnksb	똸
ccnkse	똹
ccnksx	똺
ccnksw	똻
ccnko	똼
ccnka	똽
ccnkab	똾
ccnkb	똿
ccnkbb	뙀
ccnkq	뙁
ccnku	뙂
ccnkd	뙃
ccnkz	뙄
ccnke	뙅
ccnkx	뙆
ccnkw	뙇
ccnh	뙈
ccnhy	뙉
ccnhyy	뙊
ccnhyb	뙋
ccnhl	뙌
ccnhlu	뙍
ccnhlw	뙎
ccnhc	뙏
ccnhs	뙐
ccnhsy	뙑
ccnhso	뙒
ccnhsa	뙓
ccnhsb	뙔
ccnhse	뙕
ccnhsx	뙖
ccnhsw	뙗
ccnho	뙘
ccnha	뙙
ccnhab	뙚
ccnhb	뙛
ccnhbb	뙜
ccnhq	뙝
ccnhu	뙞
ccnhd	뙟
ccnhz	뙠
ccnhe	뙡
ccnhx	뙢
ccnhw	뙣
ccni	뙤
ccniy	뙥
ccniyy	뙦
ccniyn	뙧
ccnil	뙨
ccnilu	뙩
ccnilw	뙪
ccnic	뙫
ccnis	뙬
ccnisy	뙭
ccniso	뙮
ccnisa	뙯
ccnisb	뙰
ccnise	뙱
ccnisx	뙲
ccnisw	뙳
ccnio	뙴
ccnia	뙵
ccniab	뙶
ccnib	뙷
ccnibb	뙸
ccniq	뙹
ccniu	뙺
ccnid	뙻
ccniz	뙼
ccnie	뙽
ccnix	뙾
ccniw	뙿
ccm	뚀
ccmy	뚁
ccmyy	뚂
ccmyb	뚃
ccml	뚄
ccmlu	뚅
ccmlw	뚆
ccmc	뚇
ccms	뚈
ccmsy	뚉
ccmso	뚊
ccmsa	뚋
ccmsb	뚌
ccmse	뚍
ccmsx	뚎
ccmsw	뚏
ccmo	뚐
ccma	뚑
ccmab	뚒
ccmb	뚓
ccmbb	뚔
ccmq	뚕
ccmu	뚖
ccmd	뚗
ccmz	뚘
ccme	뚙
ccmx	뚚
ccmw	뚛
cct	뚜
ccty	뚝
cctyy	뚞
cctyb	뚟
cctl	뚠
cctlu	뚡
cctlw	뚢
cctc	뚣
ccts	뚤
cctsy	뚥
cctso	뚦
cctsa	뚧
cctsb	뚨
cctse	뚩
cctsx	뚪
cctsw	뚫
ccto	뚬
ccta	뚭
cctab	뚮
cctb	뚯
cctbb	뚰
cctq	뚱
cctu	뚲
cctd	뚳
cctz	뚴
ccte	뚵
cctx	뚶
cctw	뚷
cctj	뚸
cctjy	뚹
cctjyy	뚺
cctjyb	뚻
cctjl	뚼
cctjlu	뚽
cctjlw	뚾
cctjc	뚿
cctjs	뛀
cctjsy	뛁
cctjso	뛂
cctjsa	뛃
cctjsb	뛄
cctjse	뛅
cctjsx	뛆
cctjsw	뛇
cctjo	뛈
cctja	뛉
cctjab	뛊
cctjb	뛋
cctjbb	뛌
cctjq	뛍
cctju	뛎
cctjd	뛏
cctjz	뛐
cctje	뛑
cctjx	뛒
cctjw	뛓
cctp	뛔
cctpy	뛕
cctpyy	뛖
cctpyb	뛗
cctpl	뛘
cctplu	뛙
cctplw	뛚
cctpc	뛛
cctps	뛜
cctpsy	뛝
cctpso	뛞
cctpsa	뛟
cctpsb	뛠
cctpse	뛡
cctpsx	뛢
cctpsw	뛣
cctpo	뛤
cctpa	뛥
cctpab	뛦
cctpb	뛧
cctpbb	뛨
cctpq	뛩
cctpu	뛪
cctpd	뛫
cctpz	뛬
cctpe	뛭
cctpx	뛮
cctpw	뛯
ccti	뛰
cctiy	뛱
cctiyy	뛲
cctiyb	뛳
cctil	뛴
cctilu	뛵
cctilw	뛶
cctic	뛷
cctis	뛸
cctisy	뛹
cctiso	뛺
cctisa	뛻
cctisb	뛼
cctise	뛽
cctisx	뛾
cctisw	뛿
#13
cctio	뜀
cctia	뜁
cctiab	뜂
cctib	뜃
cctibb	뜄
cctiq	뜅
cctiu	뜆
cctid	뜇
cctiz	뜈
cctie	뜉
cctix	뜊
cctiw	뜋
ccr	뜌
ccry	뜍
ccryy	뜎
ccryb	뜏
ccrl	뜐
ccrlu	뜑
ccrlw	뜒
ccrc	뜓
ccrs	뜔
ccrsy	뜕
ccrso	뜖
ccrsa	뜗
ccrsb	뜘
ccrse	뜙
ccrsx	뜚
ccrsw	뜛
ccro	뜜
ccra	뜝
ccrab	뜞
ccrb	뜟
ccrbb	뜠
ccrq	뜡
ccru	뜢
ccrd	뜣
ccrz	뜤
ccre	뜥
ccrx	뜦
ccrw	뜧
ccv	뜨
ccvy	뜩
ccvyy	뜪
ccvyb	뜫
ccvl	뜬
ccvlu	뜭
ccvlw	뜮
ccvc	뜯
ccvs	뜰
ccvsy	뜱
ccvso	뜲
ccvsa	뜳
ccvsb	뜴
ccvse	뜵
ccvsx	뜶
ccvsw	뜷
ccvo	뜸
ccva	뜹
ccvab	뜺
ccvb	뜻
ccvbb	뜼
ccvq	뜽
ccvu	뜾
ccvd	뜿
ccvz	띀
ccve	띁
ccvx	띂
ccvw	띃
ccvi	띄
ccviy	띅
ccviyy	띆
ccviyb	띇
ccvil	띈
ccvilu	띉
ccvilw	띊
ccvic	띋
ccvis	띌
ccvisy	띍
ccviso	띎
ccvisa	띏
ccvisb	띐
ccvise	띑
ccvisx	띒
ccvisw	띓
ccvio	띔
ccvia	띕
ccviab	띖
ccvib	띗
ccvibb	띘
ccviq	띙
ccviu	띚
ccvid	띛
ccviz	띜
ccvie	띝
ccvix	띞
ccviw	띟
cci	띠
cciy	띡
cciyy	띢
cciyb	띣
ccil	띤
ccilu	띥
ccilw	띦
ccic	띧
ccis	띨
ccisy	띩
cciso	띪
ccisa	띫
ccisb	띬
ccise	띭
ccisx	띮
ccisw	띯
ccio	띰
ccia	띱
cciab	띲
ccib	띳
ccibb	띴
cciq	띵
cciu	띶
ccid	띷
cciz	띸
ccie	띹
ccix	띺
cciw	띻
sk	라
sky	락
skyy	띾
skyb	띿
skl	란
sklu	랁
sklw	랂
skc	랃
sks	랄
sksy	랅
skso	랆
sksa	랇
sksb	랈
skse	랉
sksx	랊
sksw	랋
sko	람
ska	랍
skab	랎
skb	랏
skbb	랐
skq	랑
sku	랒
skd	랓
skz	랔
ske	랕
skx	랖
skw	랗
sh	래
shy	랙
shyy	랚
shyb	랛
shl	랜
shlu	랝
shlw	랞
shc	랟
shs	랠
shsy	랡
shso	랢
shsa	랣
shsb	랤
shse	랥
shsx	랦
shsw	랧
sho	램
sha	랩
shab	랪
shb	랫
shbb	랬
shq	랭
shu	랮
shd	랯
shz	랰
she	랱
shx	랲
shw	랳
sf	랴
sfy	략
sfyy	랶
sfyb	랷
sfl	랸
sflu	랹
sflw	랺
sfc	랻
sfs	랼
sfsy	랽
sfso	랾
sfsa	랿
sfsb	럀
sfse	럁
sfsx	럂
sfsw	럃
sfo	럄
sfa	럅
sfab	럆
sfb	럇
sfbb	럈
sfq	량
sfu	럊
sfd	럋
sfz	럌
sfe	럍
sfx	럎
sfw	럏
shh	럐
shhy	럑
shhyy	럒
shhyb	럓
shhl	럔
shhlu	럕
shhlw	럖
shhc	럗
shhs	럘
shhsy	럙
shhso	럚
shhsa	럛
shhsb	럜
shhse	럝
shhsx	럞
shhsw	럟
shho	럠
shha	럡
shhab	럢
shhb	럣
shhbb	럤
shhq	럥
shhu	럦
shhd	럧
shhz	럨
shhe	럩
shhx	럪
shhw	럫
sj	러
sjy	럭
sjyy	럮
sjyb	럯
sjl	런
sjlu	럱
sjlw	럲
sjc	럳
sjs	럴
sjsy	럵
sjso	럶
sjsa	럷
sjsb	럸
sjse	럹
sjsx	럺
sjsw	럻
sjo	럼
sja	럽
sjab	럾
sjb	럿
#14
sjbb	렀
sjq	렁
sju	렂
sjd	렃
sjz	렄
sje	렅
sjx	렆
sjw	렇
sp	레
spy	렉
spyy	렊
spyb	렋
spl	렌
splu	렍
splw	렎
spc	렏
sps	렐
spsy	렑
spso	렒
spsa	렓
spsb	렔
spse	렕
spsx	렖
spsw	렗
spo	렘
spa	렙
spab	렚
spb	렛
spbb	렜
spq	렝
spu	렞
spd	렟
spz	렠
spe	렡
spx	렢
spw	렣
sg	려
sgy	력
sgyy	렦
sgyb	렧
sgl	련
sglu	렩
sglw	렪
sgc	렫
sgs	렬
sgsy	렭
sgso	렮
sgsa	렯
sgsb	렰
sgse	렱
sgsx	렲
sgsw	렳
sgo	렴
sga	렵
sgab	렶
sgb	렷
sgbb	렸
sgq	령
sgu	렺
sgd	렻
sgz	렼
sge	렽
sgx	렾
sgw	렿
spp	례
sppy	롁
sppyy	롂
sppyb	롃
sppl	롄
spplu	롅
spplw	롆
sppc	롇
spps	롈
sppsy	롉
sppso	롊
sppsa	롋
sppsb	롌
sppse	롍
sppsx	롎
sppsw	롏
sppo	롐
sppa	롑
sppab	롒
sppb	롓
sppbb	롔
sppq	롕
sppu	롖
sppd	롗
sppz	롘
sppe	롙
sppx	롚
sppw	롛
sn	로
sny	록
snyy	롞
snyb	롟
snl	론
snlu	롡
snlw	롢
snc	롣
sns	롤
snsy	롥
snso	롦
snsa	롧
snsb	롨
snse	롩
snsx	롪
snsw	롫
sno	롬
sna	롭
snab	롮
snb	롯
snbb	롰
snq	롱
snu	롲
snd	롳
snz	롴
sne	롵
snx	롶
snw	롷
snk	롸
snky	롹
snkyy	롺
snkyb	롻
snkl	롼
snklu	롽
snklw	롾
snkc	롿
snks	뢀
snksy	뢁
snkso	뢂
snksa	뢃
snksb	뢄
snkse	뢅
snksx	뢆
snksw	뢇
snko	뢈
snka	뢉
snkab	뢊
snkb	뢋
snkbb	뢌
snkq	뢍
snku	뢎
snkd	뢏
snkz	뢐
snke	뢑
snkx	뢒
snkw	뢓
snh	뢔
snhy	뢕
snhyy	뢖
snhyb	뢗
snhl	뢘
snhlu	뢙
snhlw	뢚
snhc	뢛
snhs	뢜
snhsy	뢝
snhso	뢞
snhsa	뢟
snhsb	뢠
snhse	뢡
snhsx	뢢
snhsw	뢣
snho	뢤
snha	뢥
snhab	뢦
snhb	뢧
snhbb	뢨
snhq	뢩
snhu	뢪
snhd	뢫
snhz	뢬
snhe	뢭
snhx	뢮
snhw	뢯
sni	뢰
sniy	뢱
sniyy	뢲
sniyb	뢳
snil	뢴
snilu	뢵
snilw	뢶
snic	뢷
snis	뢸
snisy	뢹
sniso	뢺
snisa	뢻
snisb	뢼
snise	뢽
snisx	뢾
snisw	뢿
snio	룀
snia	룁
sniab	룂
snib	룃
snibb	룄
sniq	룅
sniu	룆
snid	룇
sniz	룈
snie	룉
snix	룊
sniw	룋
sm	료
smy	룍
smyy	룎
smyb	룏
sml	룐
smlu	룑
smlw	룒
smc	룓
sms	룔
smsy	룕
smso	룖
smsa	룗
smsb	룘
smse	룙
smsx	룚
smsw	룛
smo	룜
sma	룝
smab	룞
smb	룟
smbb	룠
smq	룡
smu	룢
smd	룣
smz	룤
sme	룥
smx	룦
smw	룧
st	루
sty	룩
styy	룪
styb	룫
stl	룬
stlu	룭
stlw	룮
stc	룯
sts	룰
stsy	룱
stso	룲
stsa	룳
stsb	룴
stse	룵
stsx	룶
stsw	룷
sto	룸
sta	룹
stab	룺
stb	룻
stbb	룼
stq	룽
stu	룾
std	룿
#15
stz	뤀
ste	뤁
stx	뤂
stw	뤃
stj	뤄
stjy	뤅
stjyy	뤆
stjyb	뤇
stjl	뤈
stjlu	뤉
stjlw	뤊
stjc	뤋
stjs	뤌
stjsy	뤍
stjso	뤎
stjsa	뤏
stjsb	뤐
stjse	뤑
stjsx	뤒
stjsw	뤓
stjo	뤔
stja	뤕
stjab	뤖
stjb	뤗
stjbb	뤘
stjq	뤙
stju	뤚
stjd	뤛
stjz	뤜
stje	뤝
stjx	뤞
stjw	뤟
stp	뤠
stpy	뤡
stpyy	뤢
stpyb	뤣
stpl	뤤
stplu	뤥
stplw	뤦
stpc	뤧
stps	뤨
stpsy	뤩
stpso	뤪
stpsa	뤫
stpsb	뤬
stpse	뤭
stpsx	뤮
stpsw	뤯
stpo	뤰
stpa	뤱
stpab	뤲
stpb	뤳
stpbb	뤴
stpq	뤵
stpu	뤶
stpd	뤷
stpz	뤸
stpe	뤹
stpx	뤺
stpw	뤻
sti	뤼
stiy	뤽
stiyy	뤾
stiyb	뤿
stil	륀
stilu	륁
stilw	륂
stic	륃
stis	륄
stisy	륅
stiso	륆
stisa	륇
stisb	륈
stise	륉
stisx	륊
stisw	륋
stio	륌
stia	륍
stiab	륎
stib	륏
stibb	륐
stiq	륑
stiu	륒
stid	륓
stiz	륔
stie	륕
stix	륖
stiw	륗
sr	류
sry	륙
sryy	륚
sryb	륛
srl	륜
srlu	륝
srlw	륞
src	륟
srs	률
srsy	륡
srso	륢
srsa	륣
srsb	륤
srse	륥
srsx	륦
srsw	륧
sro	륨
sra	륩
srab	륪
srb	륫
srbb	륬
srq	륭
sru	륮
srd	륯
srz	륰
sre	륱
srx	륲
srw	륳
sv	르
svy	륵
svyy	륶
svyb	륷
svl	른
svlu	륹
svlw	륺
svc	륻
svs	를
svsy	륽
svso	륾
svsa	륿
svsb	릀
svse	릁
svsx	릂
svsw	릃
svo	름
sva	릅
svab	릆
svb	릇
svbb	릈
svq	릉
svu	릊
svd	릋
svz	릌
sve	릍
svx	릎
svw	릏
svi	릐
sviy	릑
sviyy	릒
sviyb	릓
svil	릔
svilu	릕
svilw	릖
svic	릗
svis	릘
svisy	릙
sviso	릚
svisa	릛
svisb	릜
svise	릝
svisx	릞
svisw	릟
svio	릠
svia	릡
sviab	릢
svib	릣
svibb	릤
sviq	릥
sviu	릦
svid	릧
sviz	릨
svie	릩
svix	릪
sviw	릫
si	리
siy	릭
siyy	릮
siyb	릯
sil	린
silu	릱
silw	릲
sic	릳
sis	릴
sisy	릵
siso	릶
sisa	릷
sisb	릸
sise	릹
sisx	릺
sisw	릻
sio	림
sia	립
siab	릾
sib	릿
sibb	맀
siq	링
siu	맂
sid	맃
siz	맄
sie	맅
six	맆
siw	맇
ok	마
oky	막
okyy	맊
okyb	맋
okl	만
oklu	맍
oklw	많
okc	맏
oks	말
oksy	맑
okso	맒
oksa	맓
oksb	맔
okse	맕
oksx	맖
oksw	맗
oko	맘
oka	맙
okab	맚
okb	맛
okbb	맜
okq	망
oku	맞
okd	맟
okz	맠
oke	맡
okx	맢
okw	맣
oh	매
ohy	맥
ohyy	맦
ohyb	맧
ohl	맨
ohlu	맩
ohlw	맪
ohc	맫
ohs	맬
ohsy	맭
ohso	맮
ohka	맯
ohsb	맰
ohse	맱
ohsx	맲
ohsw	맳
oho	맴
oha	맵
ohab	맶
ohb	맷
ohbb	맸
ohq	맹
ohu	맺
ohd	맻
ohz	맼
ohe	맽
ohx	맾
ohw	맿
#16
of	먀
ofy	먁
ofyy	먂
ofyb	먃
ofl	먄
oflu	먅
oflw	먆
ofc	먇
ofs	먈
ofsy	먉
ofso	먊
ofsa	먋
ofsb	먌
ofse	먍
ofsx	먎
ofsw	먏
ofo	먐
ofa	먑
ofab	먒
ofb	먓
ofbb	먔
ofq	먕
ofu	먖
ofd	먗
ofz	먘
ofe	먙
ofx	먚
ofw	먛
ohh	먜
ohhy	먝
ohhyy	먞
ohhyb	먟
ohhl	먠
ohhlu	먡
ohhlw	먢
ohhc	먣
ohhs	먤
ohhsy	먥
ohhso	먦
ohsa	먧
ohhsb	먨
ohhse	먩
ohhsx	먪
ohhsw	먫
ohho	먬
ohha	먭
ohhab	먮
ohhb	먯
ohhbb	먰
ohhq	먱
ohhu	먲
ohhd	먳
ohhz	먴
ohhe	먵
ohhx	먶
ohhw	먷
oj	머
ojy	먹
ojyy	먺
ojyb	먻
ojl	먼
ojlu	먽
ojlw	먾
ojc	먿
ojs	멀
ojsy	멁
ojso	멂
ojsa	멃
ojsb	멄
ojse	멅
ojsx	멆
ojsw	멇
ojo	멈
oja	멉
ojab	멊
ojb	멋
ojbb	멌
ojq	멍
oju	멎
ojd	멏
ojz	멐
oje	멑
ojx	멒
ojw	멓
op	메
opy	멕
opyy	멖
opyb	멗
opl	멘
oplu	멙
oplw	멚
opc	멛
ops	멜
opsy	멝
opso	멞
opsa	멟
opsb	멠
opse	멡
opsx	멢
opsw	멣
opo	멤
opa	멥
opab	멦
opb	멧
opbb	멨
opq	멩
opu	멪
opd	멫
opz	멬
ope	멭
opx	멮
opw	멯
og	며
ogy	멱
ogyy	멲
ogyb	멳
ogl	면
oglu	멵
oglw	멶
ogc	멷
ogs	멸
ogsy	멹
ogso	멺
ogsa	멻
ogsb	멼
ogse	멽
ogsx	멾
ogsw	멿
ogo	몀
oga	몁
ogab	몂
ogb	몃
ogbb	몄
ogq	명
ogu	몆
ogd	몇
ogz	몈
oge	몉
ogx	몊
ogw	몋
opp	몌
oppy	몍
oppyy	몎
oppyb	몏
oppl	몐
opplu	몑
opplw	몒
oppc	몓
opps	몔
oppsy	몕
oppso	몖
oppsa	몗
oppsb	몘
oppse	몙
oppsx	몚
oppsw	몛
oppo	몜
oppa	몝
oppab	몞
oppb	몟
oppbb	몠
oppq	몡
oppu	몢
oppd	몣
oppz	몤
oppe	몥
oppx	몦
oppw	몧
on	모
ony	목
onyy	몪
onyb	몫
onl	몬
onlu	몭
onlw	몮
onc	몯
ons	몰
onsy	몱
onso	몲
onsa	몳
onsb	몴
onse	몵
onsx	몶
onsw	몷
ono	몸
ona	몹
onab	몺
onb	못
onbb	몼
onq	몽
onu	몾
ond	몿
onz	뫀
one	뫁
onx	뫂
onw	뫃
onk	뫄
onky	뫅
onkyy	뫆
onkyb	뫇
onkl	뫈
onklu	뫉
onklw	뫊
onkc	뫋
onks	뫌
onksy	뫍
onkso	뫎
onksa	뫏
onksb	뫐
onkse	뫑
onksx	뫒
onksw	뫓
onko	뫔
onka	뫕
onkab	뫖
onkb	뫗
onkbb	뫘
onkq	뫙
onku	뫚
onkd	뫛
onkz	뫜
onke	뫝
onkx	뫞
onkw	뫟
onh	뫠
onhy	뫡
onhyy	뫢
onhyb	뫣
onhl	뫤
onhlu	뫥
onhlw	뫦
onhc	뫧
onhs	뫨
onhsy	뫩
onhso	뫪
onhsa	뫫
onhsb	뫬
onhse	뫭
onhsx	뫮
onhsw	뫯
onho	뫰
onha	뫱
onhab	뫲
onhb	뫳
onhbb	뫴
onhq	뫵
onhu	뫶
onhd	뫷
onhz	뫸
onhe	뫹
onhx	뫺
onhw	뫻
oni	뫼
oniy	뫽
oniyy	뫾
oniyb	뫿
#17
onil	묀
onilu	묁
onilw	묂
onic	묃
onis	묄
onisy	묅
oniso	묆
onisa	묇
onisb	묈
onise	묉
onisx	묊
onisw	묋
onio	묌
onia	묍
oniab	묎
onib	묏
onibb	묐
oniq	묑
oniu	묒
onid	묓
oniz	묔
onie	묕
onix	묖
oniw	묗
om	묘
omy	묙
omyy	묚
omyb	묛
oml	묜
omlu	묝
omlw	묞
omc	묟
oms	묠
omsy	묡
omso	묢
omsa	묣
omsb	묤
omse	묥
omsx	묦
omsw	묧
omo	묨
oma	묩
omab	묪
omb	묫
ombb	묬
omq	묭
omu	묮
omd	묯
omz	묰
ome	묱
omx	묲
omw	묳
ot	무
oty	묵
otyy	묶
otyb	묷
otl	문
otlu	묹
otlw	묺
otc	묻
ots	물
otsy	묽
otso	묾
otsa	묿
otsb	뭀
otse	뭁
otsx	뭂
otsw	뭃
oto	뭄
ota	뭅
otab	뭆
otb	뭇
otbb	뭈
otq	뭉
otu	뭊
otd	뭋
otz	뭌
ote	뭍
otx	뭎
otw	뭏
otj	뭐
otjy	뭑
otjyy	뭒
otjyb	뭓
otjl	뭔
otjlu	뭕
otjlw	뭖
otjc	뭗
otjs	뭘
otjsy	뭙
otjso	뭚
otjsa	뭛
otjsb	뭜
otjse	뭝
otjsx	뭞
otjsw	뭟
otjo	뭠
otja	뭡
otjab	뭢
otjb	뭣
otjbb	뭤
otjq	뭥
otju	뭦
otjd	뭧
otjz	뭨
otje	뭩
otjx	뭪
otjw	뭫
otp	뭬
otpy	뭭
otpyy	뭮
otpyb	뭯
otpl	뭰
otplu	뭱
otplw	뭲
otpc	뭳
otps	뭴
otpsy	뭵
otpso	뭶
otpsa	뭷
otpsb	뭸
otpse	뭹
otpsx	뭺
otpsw	뭻
otpo	뭼
otpa	뭽
otpab	뭾
otpb	뭿
otpbb	뮀
otpq	뮁
otpu	뮂
otpd	뮃
otpz	뮄
otpe	뮅
otpx	뮆
otpw	뮇
oti	뮈
otiy	뮉
otiyy	뮊
otiyb	뮋
otil	뮌
otilu	뮍
otilw	뮎
otic	뮏
otis	뮐
otisy	뮑
otiso	뮒
otisa	뮓
otisb	뮔
otise	뮕
otisx	뮖
otisw	뮗
otio	뮘
otia	뮙
otiab	뮚
otib	뮛
otibb	뮜
otiq	뮝
otiu	뮞
otid	뮟
otiz	뮠
otie	뮡
otix	뮢
otiw	뮣
or	뮤
ory	뮥
oryy	뮦
oryb	뮧
orl	뮨
orlu	뮩
orlw	뮪
orc	뮫
ors	뮬
orsy	뮭
orso	뮮
orsa	뮯
orsb	뮰
orse	뮱
orsx	뮲
orsw	뮳
oro	뮴
ora	뮵
orab	뮶
orb	뮷
orbb	뮸
orq	뮹
oru	뮺
ord	뮻
orz	뮼
ore	뮽
orx	뮾
orw	뮿
ov	므
ovy	믁
ovyy	믂
ovyb	믃
ovl	믄
ovlu	믅
ovlw	믆
ovc	믇
ovs	믈
ovsy	믉
ovso	믊
ovsa	믋
ovsb	믌
ovse	믍
ovsx	믎
ovsw	믏
ovo	믐
ova	믑
ovab	믒
ovb	믓
ovbb	믔
ovq	믕
ovu	믖
ovd	믗
ovz	믘
ove	믙
ovx	믚
ovw	믛
ovi	믜
oviy	믝
oviyy	믞
oviyb	믟
ovil	믠
ovilu	믡
ovilw	믢
ovic	믣
ovis	믤
ovisy	믥
oviso	믦
ovisa	믧
ovisb	믨
ovise	믩
ovisx	믪
ovisw	믫
ovio	믬
ovia	믭
oviab	믮
ovib	믯
ovibb	믰
oviq	믱
oviu	믲
ovid	믳
oviz	믴
ovie	믵
ovix	믶
oviw	믷
oi	미
oiy	믹
oiyy	믺
oiyb	믻
oil	민
oilu	믽
oilw	믾
oic	믿
#18
ois	밀
oisy	밁
oiso	밂
oisa	밃
oisb	밄
oise	밅
oisx	밆
oisw	밇
oio	밈
oia	밉
oiab	밊
oib	밋
oibb	밌
oiq	밍
oiu	밎
oid	및
oiz	밐
oie	밑
oix	밒
oiw	밓
ak	바
aky	박
akyy	밖
akyz	밗
akl	반
aklu	밙
aklw	밚
akc	받
aks	발
aksy	밝
akso	밞
aksa	밟
aksb	밠
akse	밡
aksx	밢
aksw	밣
ako	밤
aka	밥
akab	밦
akb	밧
akbb	밨
akq	방
aku	밪
akd	밫
akz	밬
ake	밭
akx	밮
akw	밯
ah	배
ahy	백
ahyy	밲
ahyb	밳
ahl	밴
ahlu	밵
ahlw	밶
ahc	밷
ahs	밸
ahsy	밹
ahso	밺
ahsa	밻
ahsb	밼
ahse	밽
ahsx	밾
ahsw	밿
aho	뱀
aha	뱁
ahab	뱂
ahb	뱃
ahbb	뱄
ahq	뱅
ahu	뱆
ahd	뱇
ahz	뱈
ahe	뱉
ahx	뱊
ahw	뱋
af	뱌
afy	뱍
afyy	뱎
afyb	뱏
afl	뱐
aflu	뱑
aflw	뱒
afc	뱓
afs	뱔
afsy	뱕
afso	뱖
afsa	뱗
afsb	뱘
afse	뱙
afsx	뱚
afsw	뱛
afo	뱜
afa	뱝
afab	뱞
afb	뱟
afbb	뱠
afq	뱡
afu	뱢
afd	뱣
afz	뱤
afe	뱥
afx	뱦
afw	뱧
ahh	뱨
ahhy	뱩
ahhyy	뱪
ahhyb	뱫
ahhl	뱬
ahhlu	뱭
ahhlw	뱮
ahhc	뱯
ahhs	뱰
ahhsy	뱱
ahhso	뱲
ahhsa	뱳
ahhsb	뱴
ahhse	뱵
ahhsx	뱶
ahhsw	뱷
ahho	뱸
ahha	뱹
ahhab	뱺
ahhb	뱻
ahhbb	뱼
ahhq	뱽
ahhu	뱾
ahhd	뱿
ahhz	벀
ahhe	벁
ahhx	벂
ahhw	벃
aj	버
ajy	벅
ajyy	벆
ajyb	벇
ajl	번
ajlu	벉
ajlw	벊
ajc	벋
ajs	벌
ajsy	벍
ajso	벎
ajsa	벏
ajsb	벐
ajse	벑
ajsx	벒
ajsw	벓
ajo	범
aja	법
ajab	벖
ajb	벗
ajbb	벘
ajq	벙
aju	벚
ajd	벛
ajz	벜
aje	벝
ajx	벞
ajw	벟
ap	베
apy	벡
apyy	벢
apyb	벣
apl	벤
aplu	벥
aplw	벦
apc	벧
aps	벨
apsy	벩
apso	벪
apsa	벫
apsb	벬
apse	벭
apsx	벮
apsw	벯
apo	벰
apa	벱
apab	벲
apb	벳
apbb	벴
apq	벵
apu	벶
apd	벷
apz	벸
ape	벹
apx	벺
apw	벻
ag	벼
agy	벽
agyy	벾
agyb	벿
agl	변
aglu	볁
aglw	볂
agc	볃
ags	별
agsy	볅
agso	볆
agsa	볇
agsb	볈
agse	볉
agsx	볊
agsw	볋
ago	볌
aga	볍
agab	볎
agb	볏
agbb	볐
agq	병
agu	볒
agd	볓
agz	볔
age	볕
agx	볖
agw	볗
app	볘
appy	볙
appyy	볚
appyb	볛
appl	볜
applu	볝
applw	볞
appc	볟
apps	볠
appsy	볡
appso	볢
appsa	볣
appsb	볤
appse	볥
appsx	볦
appsw	볧
appo	볨
appa	볩
appab	볪
appb	볫
appbb	볬
appq	볭
appu	볮
appd	볯
appz	볰
appe	볱
appx	볲
appw	볳
an	보
any	복
anyy	볶
anyb	볷
anl	본
anlu	볹
anlw	볺
anc	볻
ans	볼
ansy	볽
anso	볾
ansa	볿
#19
ansb	봀
anse	봁
ansx	봂
answ	봃
ano	봄
ana	봅
anab	봆
anb	봇
anbb	봈
anq	봉
anu	봊
and	봋
anz	봌
ane	봍
anx	봎
anw	봏
ank	봐
anky	봑
ankyy	봒
ankyb	봓
ankl	봔
anklu	봕
anklw	봖
ankc	봗
anks	봘
anksy	봙
ankso	봚
anksa	봛
anksb	봜
ankse	봝
anksx	봞
anksw	봟
anko	봠
anka	봡
ankab	봢
ankb	봣
ankbb	봤
ankq	봥
anku	봦
ankd	봧
ankz	봨
anke	봩
ankx	봪
ankw	봫
anh	봬
anhy	봭
anhyy	봮
anhyb	봯
anhl	봰
anhlu	봱
anhlw	봲
anhc	봳
anhs	봴
anhsy	봵
anhso	봶
anhsa	봷
anhsb	봸
anhse	봹
anhsx	봺
anhsw	봻
anho	봼
anha	봽
anhab	봾
anhb	봿
anhbb	뵀
anhq	뵁
anhu	뵂
anhd	뵃
anhz	뵄
anhe	뵅
anhx	뵆
anhw	뵇
ani	뵈
aniy	뵉
aniyy	뵊
aniyb	뵋
anil	뵌
anilu	뵍
anilw	뵎
anic	뵏
anis	뵐
anisy	뵑
aniso	뵒
anisa	뵓
anisb	뵔
anise	뵕
anisx	뵖
anisw	뵗
anio	뵘
ania	뵙
aniab	뵚
anib	뵛
anibb	뵜
aniq	뵝
aniu	뵞
anid	뵟
aniz	뵠
anie	뵡
anix	뵢
aniw	뵣
am	뵤
amy	뵥
amyy	뵦
amyb	뵧
aml	뵨
amlu	뵩
amlw	뵪
amc	뵫
ams	뵬
amsy	뵭
amso	뵮
amsa	뵯
amsb	뵰
amse	뵱
amsx	뵲
amsw	뵳
amo	뵴
ama	뵵
amab	뵶
amb	뵷
ambb	뵸
amq	뵹
amu	뵺
amd	뵻
amz	뵼
ame	뵽
amx	뵾
amw	뵿
at	부
aty	북
atyy	붂
atyb	붃
atl	분
atlu	붅
atlw	붆
atc	붇
ats	불
atsy	붉
atso	붊
atsa	붋
atsb	붌
atse	붍
atsx	붎
atsw	붏
ato	붐
ata	붑
atab	붒
atb	붓
atbb	붔
atq	붕
atu	붖
atd	붗
atz	붘
ate	붙
atx	붚
atw	붛
atj	붜
atjy	붝
atjyy	붞
atjyb	붟
atjl	붠
atjld	붡
atjlw	붢
atjc	붣
atjs	붤
atjsy	붥
atjso	붦
atjsa	붧
atjsb	붨
atjse	붩
atjsx	붪
atjsw	붫
atjo	붬
atja	붭
atjab	붮
atjb	붯
atjbb	붰
atjq	붱
atju	붲
atjd	붳
atjz	붴
atje	붵
atjx	붶
atjw	붷
atp	붸
atpy	붹
atpyy	붺
atpyb	붻
atpl	붼
atplu	붽
atplw	붾
atpc	붿
atps	뷀
atpsy	뷁
atpso	뷂
atpsa	뷃
atpsb	뷄
atpse	뷅
atpsx	뷆
atpsw	뷇
atpo	뷈
atpa	뷉
atpab	뷊
atpb	뷋
atpbb	뷌
atpq	뷍
atpu	뷎
atpd	뷏
atpz	뷐
atpe	뷑
atpx	뷒
atpw	뷓
ati	뷔
atiy	뷕
atiyy	뷖
atiyb	뷗
atil	뷘
atilu	뷙
atilw	뷚
atic	뷛
atis	뷜
atisy	뷝
atiso	뷞
atisa	뷟
atisb	뷠
atise	뷡
atisx	뷢
atisw	뷣
atio	뷤
atia	뷥
atiab	뷦
atib	뷧
atibb	뷨
atiq	뷩
atiu	뷪
atid	뷫
atiz	뷬
atie	뷭
atix	뷮
atiw	뷯
ar	뷰
ary	뷱
aryy	뷲
aryb	뷳
arl	뷴
arlu	뷵
arlw	뷶
arc	뷷
ars	뷸
arsy	뷹
arso	뷺
arsa	뷻
arsb	뷼
arse	뷽
arsx	뷾
arsw	뷿
#20
aro	븀
ara	븁
arab	븂
arb	븃
arbb	븄
arq	븅
aru	븆
ard	븇
arz	븈
are	븉
arx	븊
arw	븋
av	브
avy	븍
avyy	븎
avyb	븏
avl	븐
avlu	븑
avlw	븒
avc	븓
avs	블
avsy	븕
avso	븖
avsa	븗
avsb	븘
avse	븙
avsx	븚
avsw	븛
avo	븜
ava	븝
avab	븞
avb	븟
avbb	븠
avq	븡
avu	븢
avd	븣
avz	븤
ave	븥
avx	븦
avw	븧
avi	븨
aviy	븩
aviyy	븪
aviyb	븫
avil	븬
avilu	븭
avilw	븮
avic	븯
avis	븰
avisy	븱
aviso	븲
avisa	븳
avisb	븴
avise	븵
avisx	븶
avisw	븷
avio	븸
avia	븹
aviab	븺
avib	븻
avibb	븼
aviq	븽
aviu	븾
avid	븿
aviz	빀
avie	빁
avix	빂
aviw	빃
ai	비
aiy	빅
aiyy	빆
aiyb	빇
ail	빈
ailu	빉
ailw	빊
aic	빋
ais	빌
aisy	빍
aiso	빎
aisa	빏
aisb	빐
aise	빑
aisx	빒
aisw	빓
aio	빔
aia	빕
aiab	빖
aib	빗
aibb	빘
aiq	빙
aiu	빚
aid	빛
aiz	빜
aie	빝
aix	빞
aiw	빟
aak	빠
aaky	빡
aakyy	빢
aakyb	빣
aakl	빤
aaklu	빥
aaklw	빦
aakc	빧
aaks	빨
aaksy	빩
aakso	빪
aaksa	빫
aaksb	빬
aakse	빭
aaksx	빮
aaksw	빯
aako	빰
aaka	빱
aakab	빲
aakb	빳
aakbb	빴
aakq	빵
aaku	빶
aakd	빷
aakz	빸
aake	빹
aakx	빺
aakw	빻
aah	빼
aahy	빽
aahyy	빾
aahyb	빿
aahl	뺀
aahlu	뺁
aahlw	뺂
aahc	뺃
aahs	뺄
aahsy	뺅
aahso	뺆
aahsa	뺇
aahsb	뺈
aahse	뺉
aahsx	뺊
aahsw	뺋
aaho	뺌
aaha	뺍
aahab	뺎
aahb	뺏
aahbb	뺐
aahq	뺑
aahu	뺒
aahd	뺓
aahz	뺔
aahe	뺕
aahx	뺖
aahw	뺗
aaf	뺘
aafy	뺙
aafyy	뺚
aafyb	뺛
aafl	뺜
aaflu	뺝
aaflw	뺞
aafc	뺟
aafs	뺠
aafsy	뺡
aafso	뺢
aafsa	뺣
aafsb	뺤
aafse	뺥
aafsx	뺦
aafsw	뺧
aafo	뺨
aafa	뺩
aafab	뺪
aafb	뺫
aafbb	뺬
aafq	뺭
aafu	뺮
aafd	뺯
aafz	뺰
aafe	뺱
aafx	뺲
aafw	뺳
vah	뺴
vahy	뺵
vahyy	뺶
vahyb	뺷
vahl	뺸
vahlu	뺹
vahlw	뺺
vahc	뺻
vahs	뺼
vahsy	뺽
vahso	뺾
vahsa	뺿
vahsb	뻀
vahse	뻁
vahsx	뻂
vahsw	뻃
vaho	뻄
vaha	뻅
vahab	뻆
vahb	뻇
vahbb	뻈
vahq	뻉
vahu	뻊
vahd	뻋
vahz	뻌
vahe	뻍
vahx	뻎
vahw	뻏
aaj	뻐
aajy	뻑
aajyy	뻒
aajyb	뻓
aajl	뻔
aajlu	뻕
aajlw	뻖
aajc	뻗
aajs	뻘
aajsy	뻙
aajso	뻚
aajsa	뻛
aajsb	뻜
aajse	뻝
aajsx	뻞
aajsw	뻟
aajo	뻠
aaja	뻡
aajab	뻢
aajb	뻣
aajbb	뻤
aajq	뻥
aaju	뻦
aajd	뻧
aajz	뻨
aaje	뻩
aajx	뻪
aajw	뻫
aap	뻬
aapy	뻭
aapyy	뻮
aapyb	뻯
aapl	뻰
aaplu	뻱
aaplw	뻲
aapc	뻳
aaps	뻴
aapsy	뻵
aapso	뻶
aapsa	뻷
aapsb	뻸
aapse	뻹
aapsx	뻺
aapsw	뻻
aapo	뻼
aapa	뻽
aapab	뻾
aapb	뻿
#21
aapbb	뼀
aapq	뼁
aapu	뼂
aapd	뼃
aapz	뼄
aape	뼅
aapx	뼆
aapw	뼇
aag	뼈
aagy	뼉
aagyy	뼊
aagyb	뼋
aagl	뼌
aaglu	뼍
aaglw	뼎
aagc	뼏
aags	뼐
aagsy	뼑
aagso	뼒
aagsa	뼓
aagsb	뼔
aagse	뼕
aagsx	뼖
aagsw	뼗
aago	뼘
aaga	뼙
aagab	뼚
aagb	뼛
aagbb	뼜
aagq	뼝
aagu	뼞
aagd	뼟
aagz	뼠
aage	뼡
aagx	뼢
aagw	뼣
vap	뼤
vapy	뼥
vapyy	뼦
vapyb	뼧
vapl	뼨
vaplu	뼩
vaplw	뼪
vapc	뼫
vaps	뼬
vapsy	뼭
vapso	뼮
vapsa	뼯
vapsb	뼰
vapse	뼱
vapsx	뼲
vapsw	뼳
vapo	뼴
vapa	뼵
vapab	뼶
vapb	뼷
vapbb	뼸
vapq	뼹
vapu	뼺
vapd	뼻
vapz	뼼
vape	뼽
vapx	뼾
vapw	뼿
aan	뽀
aany	뽁
aanyy	뽂
aanyb	뽃
aanl	뽄
aanlu	뽅
aanlw	뽆
aanc	뽇
aans	뽈
aansy	뽉
aanso	뽊
aansa	뽋
aansb	뽌
aanse	뽍
aansx	뽎
aansw	뽏
aano	뽐
aana	뽑
aanab	뽒
aanb	뽓
aanbb	뽔
aanq	뽕
aanu	뽖
aand	뽗
aanz	뽘
aane	뽙
aanx	뽚
aanw	뽛
aank	뽜
aanky	뽝
aankyy	뽞
aankyb	뽟
aankl	뽠
aanklu	뽡
aanklw	뽢
aankc	뽣
aanks	뽤
aanksy	뽥
aankso	뽦
aanksa	뽧
aanksb	뽨
aankse	뽩
aanksx	뽪
aanksw	뽫
aanko	뽬
aanka	뽭
aankab	뽮
aankb	뽯
aankbb	뽰
aankq	뽱
aanku	뽲
aankd	뽳
aankz	뽴
aanke	뽵
aankx	뽶
aankw	뽷
aanh	뽸
aanhy	뽹
aanhyy	뽺
aanhyb	뽻
aanhl	뽼
aanhlu	뽽
aanhlw	뽾
aanhc	뽿
aanhs	뾀
aanhsy	뾁
aanhso	뾂
aanhsa	뾃
aanhsb	뾄
aanhse	뾅
aanhsx	뾆
aanhsw	뾇
aanho	뾈
aanha	뾉
aanhab	뾊
aanhb	뾋
aanhbb	뾌
aanhq	뾍
aanhu	뾎
aanhd	뾏
aanhz	뾐
aanhe	뾑
aanhx	뾒
aanhw	뾓
aani	뾔
aaniy	뾕
aaniyy	뾖
aaniyb	뾗
aanil	뾘
aanilu	뾙
aanilw	뾚
aanic	뾛
aanis	뾜
aanisy	뾝
aaniso	뾞
aanisa	뾟
aanisb	뾠
aanise	뾡
aanisx	뾢
aanisw	뾣
aanio	뾤
aania	뾥
aaniab	뾦
aanib	뾧
aanibb	뾨
aaniq	뾩
aaniu	뾪
aanid	뾫
aaniz	뾬
aanie	뾭
aanix	뾮
aaniw	뾯
aam	뾰
aamy	뾱
aamyy	뾲
aamyb	뾳
aaml	뾴
aamlu	뾵
aamlw	뾶
aamc	뾷
aams	뾸
aamsy	뾹
aamso	뾺
aamsa	뾻
aamsb	뾼
aamse	뾽
aamsx	뾾
aamsw	뾿
aamo	뿀
aama	뿁
aamab	뿂
aamb	뿃
aambb	뿄
aamq	뿅
aamu	뿆
aamd	뿇
aamz	뿈
aame	뿉
aamx	뿊
aamw	뿋
aat	뿌
aaty	뿍
aatyy	뿎
aatyb	뿏
aatl	뿐
aatlu	뿑
aatlw	뿒
aatc	뿓
aats	뿔
aatsy	뿕
aatso	뿖
aatsa	뿗
aatsb	뿘
aatse	뿙
aatsx	뿚
aatsw	뿛
aato	뿜
aata	뿝
aatab	뿞
aatb	뿟
aatbb	뿠
aatq	뿡
aatu	뿢
aatd	뿣
aatz	뿤
aate	뿥
aatx	뿦
aatw	뿧
aatj	뿨
aatjy	뿩
aatjyy	뿪
aatjyb	뿫
aatjl	뿬
aatjlu	뿭
aatjlw	뿮
aatjc	뿯
aatjs	뿰
aatjsy	뿱
aatjso	뿲
aatjsa	뿳
aatjsb	뿴
aatjse	뿵
aatjsx	뿶
aatjsw	뿷
aatjo	뿸
aatja	뿹
aatjab	뿺
aatjb	뿻
aatjbb	뿼
aatjq	뿽
aatju	뿾
aatjd	뿿
#22
aatjz	쀀
aatje	쀁
aatjx	쀂
aatjw	쀃
aatp	쀄
aatpy	쀅
aatpyy	쀆
aatpyb	쀇
aatpl	쀈
aatplu	쀉
aatplw	쀊
aatpc	쀋
aatps	쀌
aatpsy	쀍
aatpso	쀎
aatpsa	쀏
aatpsb	쀐
aatpse	쀑
aatpsx	쀒
aatpsw	쀓
aatpo	쀔
aatpa	쀕
aatpab	쀖
aatpb	쀗
aatpbb	쀘
aatpq	쀙
aatpu	쀚
aatpd	쀛
aatpz	쀜
aatpe	쀝
aatpx	쀞
aatpw	쀟
aati	쀠
aatiy	쀡
aatiyy	쀢
aatiyb	쀣
aatil	쀤
aatilu	쀥
aatilw	쀦
aatic	쀧
aatis	쀨
aatisy	쀩
aatiso	쀪
aatisa	쀫
aatisb	쀬
aatise	쀭
aatisx	쀮
aatisw	쀯
aatio	쀰
aatia	쀱
aatiab	쀲
aatib	쀳
aatibb	쀴
aatiq	쀵
aatiu	쀶
aatid	쀷
aatiz	쀸
aatie	쀹
aatix	쀺
aatiw	쀻
aar	쀼
aary	쀽
aaryy	쀾
aaryb	쀿
aarl	쁀
aarlu	쁁
aarlw	쁂
aarc	쁃
aars	쁄
aarsy	쁅
aarso	쁆
aarsa	쁇
aarsb	쁈
aarse	쁉
aarsx	쁊
aarsw	쁋
aaro	쁌
aara	쁍
aarab	쁎
aarb	쁏
aarbb	쁐
aarq	쁑
aaru	쁒
aard	쁓
aarz	쁔
aare	쁕
aarx	쁖
aarw	쁗
aav	쁘
aavy	쁙
aavyy	쁚
aavyb	쁛
aavl	쁜
aavlu	쁝
aavlw	쁞
aavc	쁟
aavs	쁠
aavsy	쁡
aavso	쁢
aavsa	쁣
aavsb	쁤
aavse	쁥
aavsx	쁦
aavsw	쁧
aavo	쁨
aava	쁩
aavab	쁪
aavb	쁫
aavbb	쁬
aavq	쁭
aavu	쁮
aavd	쁯
aavz	쁰
aave	쁱
aavx	쁲
aavw	쁳
aavi	쁴
aaviy	쁵
aaviyy	쁶
aaviyb	쁷
aavil	쁸
aavilu	쁹
aavilw	쁺
aavic	쁻
aavis	쁼
aavisy	쁽
aaviso	쁾
aavisa	쁿
aavisb	삀
aavise	삁
aavisx	삂
aavisw	삃
aavio	삄
aavia	삅
aaviab	삆
aavib	삇
aavibb	삈
aaviq	삉
aaviu	삊
aavid	삋
aaviz	삌
aavie	삍
aavix	삎
aaviw	삏
aai	삐
aaiy	삑
aaiyy	삒
aaiyb	삓
aail	삔
aailu	삕
aailw	삖
aaic	삗
aais	삘
aaisy	삙
aaiso	삚
aaisa	삛
aaisb	삜
aaise	삝
aaisx	삞
aaisw	삟
aaio	삠
aaia	삡
aaiab	삢
aaib	삣
aaibb	삤
aaiq	삥
aaiu	삦
aaid	삧
aaiz	삨
aaie	삩
aaix	삪
aaiw	삫
bk	사
bky	삭
bkyy	삮
bkyb	삯
bkl	산
bklu	삱
bklw	삲
bkc	삳
bks	살
bksy	삵
bkso	삶
bksa	삷
bksb	삸
bkse	삹
bksx	삺
bksw	삻
bko	삼
bka	삽
bkab	삾
bkb	삿
bkbb	샀
bkq	상
bku	샂
bkd	샃
bkz	샄
bke	샅
bkx	샆
bkw	샇
bh	새
bhy	색
bhyy	샊
bhyb	샋
bhl	샌
bhlu	샍
bhlw	샎
bhc	샏
bhs	샐
bhsy	샑
bhso	샒
bhsa	샓
bhsb	샔
bhse	샕
bhsx	샖
bhsw	샗
bho	샘
bha	샙
bhab	샚
bhb	샛
bhbb	샜
bhq	생
bhu	샞
bhd	샟
bhz	샠
bhe	샡
bhx	샢
bhw	샣
bf	샤
bfy	샥
bfyy	샦
bfyb	샧
bfl	샨
bflu	샩
bflw	샪
bfc	샫
bfs	샬
bfsy	샭
bfso	샮
bfsa	샯
bfsb	샰
bfse	샱
bfsx	샲
bfsw	샳
bfo	샴
bfa	샵
bfab	샶
bfb	샷
bfbb	샸
bfq	샹
bfu	샺
bfd	샻
bfz	샼
bfe	샽
bfx	샾
bfw	샿
#23
bhh	섀
bhhy	섁
bhhyy	섂
bhhyb	섃
bhhl	섄
bhhlu	섅
bhhlw	섆
bhhc	섇
bhhs	섈
bhhsy	섉
bhhso	섊
bhhsa	섋
bhhsb	섌
bhhse	섍
bhhsx	섎
bhhsw	섏
bhho	섐
bhha	섑
bhhab	섒
bhhb	섓
bhhbb	섔
bhhq	섕
bhhu	섖
bhhd	섗
bhhz	섘
bhhe	섙
bhhx	섚
bhhw	섛
bj	서
bjy	석
bjyy	섞
bjyb	섟
bjl	선
bjlu	섡
bjlw	섢
bjc	섣
bjs	설
bjsy	섥
bjso	섦
bjsa	섧
bjsb	섨
bjse	섩
bjsx	섪
bjsw	섫
bjo	섬
bja	섭
bjab	섮
bjb	섯
bjbb	섰
bjq	성
bju	섲
bjd	섳
bjz	섴
bje	섵
bjx	섶
bjw	섷
bp	세
bpy	섹
bpyy	섺
bpyb	섻
bpl	센
bplu	섽
bplw	섾
bpc	섿
bps	셀
bpsy	셁
bpso	셂
bpsa	셃
bpsb	셄
bpse	셅
bpsx	셆
bpsw	셇
bpo	셈
bpa	셉
bpab	셊
bpb	셋
bpbb	셌
bpq	셍
bpu	셎
bpd	셏
bpz	셐
bpe	셑
bpx	셒
bpw	셓
bg	셔
bgy	셕
bgyy	셖
bgyb	셗
bgl	션
bglu	셙
bglw	셚
bgc	셛
bgs	셜
bgsy	셝
bgso	셞
bgsa	셟
bgsb	셠
bgse	셡
bgsx	셢
bgsw	셣
bgo	셤
bga	셥
bgab	셦
bgb	셧
bgbb	셨
bgq	셩
bgu	셪
bgd	셫
bgz	셬
bge	셭
bgx	셮
bgw	셯
bpp	셰
bppy	셱
bppyy	셲
bppyb	셳
bppl	셴
bpplu	셵
bpplw	셶
bppc	셷
bpps	셸
bppsy	셹
bppso	셺
bppsa	셻
bppsb	셼
bppse	셽
bppsx	셾
bppsw	셿
bppo	솀
bppa	솁
bppab	솂
bppb	솃
bppbb	솄
bppq	솅
bppu	솆
bppd	솇
bppz	솈
bppe	솉
bppx	솊
bppw	솋
bn	소
bny	속
bnyy	솎
bnyb	솏
bnl	손
bnlu	솑
bnlw	솒
bnc	솓
bns	솔
bnsy	솕
bnso	솖
bnsa	솗
bnsb	솘
bnse	솙
bnsx	솚
bnsw	솛
bno	솜
bna	솝
bnab	솞
bnb	솟
bnbb	솠
bnq	송
bnu	솢
bnd	솣
bnz	솤
bne	솥
bnx	솦
bnw	솧
bnk	솨
bnky	솩
bnkyy	솪
bnkyb	솫
bnkl	솬
bnklu	솭
bnklw	솮
bnkc	솯
bnks	솰
bnksy	솱
bnkso	솲
bnksa	솳
bnksb	솴
bnkse	솵
bnksx	솶
bnksw	솷
bnko	솸
bnka	솹
bnkab	솺
bnkb	솻
bnkbb	솼
bnkq	솽
bnku	솾
bnkd	솿
bnkz	쇀
bnke	쇁
bnkx	쇂
bnkw	쇃
bnh	쇄
bnhy	쇅
bnhyy	쇆
bnhyb	쇇
bnhl	쇈
bnhlu	쇉
bnhlw	쇊
bnhc	쇋
bnhs	쇌
bnhsy	쇍
bnhso	쇎
bnhsa	쇏
bnhsb	쇐
bnhse	쇑
bnhsx	쇒
bnhsw	쇓
bnho	쇔
bnha	쇕
bnhab	쇖
bnhb	쇗
bnhbb	쇘
bnhq	쇙
bnhu	쇚
bnhd	쇛
bnhz	쇜
bnhe	쇝
bnhx	쇞
bnhw	쇟
bni	쇠
bniy	쇡
bniyy	쇢
bniyb	쇣
bnil	쇤
bnilu	쇥
bnilw	쇦
bnic	쇧
bnis	쇨
bnisy	쇩
bniso	쇪
bnisa	쇫
bnisb	쇬
bnise	쇭
bnisx	쇮
bnisw	쇯
bnio	쇰
bnia	쇱
bniab	쇲
bnib	쇳
bnibb	쇴
bniq	쇵
bniu	쇶
bnid	쇷
bniz	쇸
bnie	쇹
bnix	쇺
bniw	쇻
bm	쇼
bmy	쇽
bmyy	쇾
bmyb	쇿
#24
bml	숀
bmlu	숁
bmlw	숂
bmc	숃
bms	숄
bmsy	숅
bmso	숆
bmsa	숇
bmsb	숈
bmse	숉
bmsx	숊
bmsw	숋
bmo	숌
bma	숍
bmab	숎
bmb	숏
bmbb	숐
bmq	숑
bmu	숒
bmd	숓
bmz	숔
bme	숕
bmx	숖
bmw	숗
bt	수
bty	숙
btyy	숚
btyb	숛
btl	순
btlu	숝
btlw	숞
btc	숟
bts	술
btsy	숡
btso	숢
btsa	숣
btsb	숤
btse	숥
btsx	숦
btsw	숧
bto	숨
bta	숩
btab	숪
btb	숫
btbb	숬
btq	숭
btu	숮
btd	숯
btz	숰
bte	숱
btx	숲
btw	숳
btj	숴
btjy	숵
btjyy	숶
btjyb	숷
btjl	숸
btjlu	숹
btjlw	숺
btjc	숻
btjs	숼
btjsy	숽
btjso	숾
btjsa	숿
btjsb	쉀
btjse	쉁
btjsx	쉂
btjsw	쉃
btjo	쉄
btja	쉅
btjab	쉆
btjb	쉇
btjbb	쉈
btjq	쉉
btju	쉊
btjd	쉋
btjz	쉌
btje	쉍
btjx	쉎
btjw	쉏
btp	쉐
btpy	쉑
btpyy	쉒
btpyb	쉓
btpl	쉔
btplu	쉕
btplw	쉖
btpc	쉗
btps	쉘
btpsy	쉙
btpso	쉚
btpsa	쉛
btpsb	쉜
btpse	쉝
btpsx	쉞
btpsw	쉟
btpo	쉠
btpa	쉡
btpab	쉢
btpb	쉣
btpbb	쉤
btpq	쉥
btpu	쉦
btpd	쉧
btpz	쉨
btpe	쉩
btpx	쉪
btpw	쉫
bti	쉬
btiy	쉭
btiyy	쉮
btiyb	쉯
btil	쉰
btilu	쉱
btilw	쉲
btic	쉳
btis	쉴
btisy	쉵
btiso	쉶
btisa	쉷
btisb	쉸
btise	쉹
btisx	쉺
btisw	쉻
btio	쉼
btia	쉽
btiab	쉾
btib	쉿
btibb	슀
btiq	슁
btiu	슂
btid	슃
btiz	슄
btie	슅
btix	슆
btiw	슇
br	슈
bry	슉
bryy	슊
bryb	슋
brl	슌
brlu	슍
brlw	슎
brc	슏
brs	슐
brsy	슑
brso	슒
brsa	슓
brsb	슔
brse	슕
brsx	슖
brsw	슗
bro	슘
bra	슙
brab	슚
brb	슛
brbb	슜
brq	슝
bru	슞
brd	슟
brz	슠
bre	슡
brx	슢
brw	슣
bv	스
bvy	슥
bvyy	슦
bvyb	슧
bvl	슨
bvlu	슩
bvlw	슪
bvc	슫
bvs	슬
bvsy	슭
bvso	슮
bvsa	슯
bvsb	슰
bvse	슱
bvsx	슲
bvsw	슳
bvo	슴
bva	습
bvab	슶
bvb	슷
bvbb	슸
bvq	승
bvu	슺
bvd	슻
bvz	슼
bve	슽
bvx	슾
bvw	슿
bvi	싀
bviy	싁
bviyy	싂
bviyb	싃
bvil	싄
bvilu	싅
bvilw	싆
bvic	싇
bvis	싈
bvisy	싉
bviso	싊
bvisa	싋
bvisb	싌
bvise	싍
bvisx	싎
bvisw	싏
bvio	싐
bvia	싑
bviab	싒
bvib	싓
bvibb	싔
bviq	싕
bviu	싖
bvid	싗
bviz	싘
bvie	싙
bvix	싚
bviw	싛
bi	시
biy	식
biyy	싞
biyb	싟
bil	신
bilu	싡
bilw	싢
bic	싣
bis	실
bisy	싥
biso	싦
bisa	싧
bisb	싨
bise	싩
bisx	싪
bisw	싫
bio	심
bia	십
biab	싮
bib	싯
bibb	싰
biq	싱
biu	싲
bid	싳
biz	싴
bie	싵
bix	싶
biw	싷
bbk	싸
bbky	싹
bbkyy	싺
bbkyb	싻
bbkl	싼
bbklu	싽
bbklw	싾
bbkc	싿
#25
bbks	쌀
bbksy	쌁
bbkso	쌂
bbksa	쌃
bbksb	쌄
bbkse	쌅
bbksx	쌆
bbksw	쌇
bbko	쌈
bbka	쌉
bbkab	쌊
bbkb	쌋
bbkbb	쌌
bbkq	쌍
bbku	쌎
bbkd	쌏
bbkz	쌐
bbke	쌑
bbkx	쌒
bbkw	쌓
bbh	쌔
bbhy	쌕
bbhyy	쌖
bbhyb	쌗
bbhl	쌘
bbhlu	쌙
bbhlw	쌚
bbhc	쌛
bbhs	쌜
bbhsy	쌝
bbhso	쌞
bbhsa	쌟
bbhsb	쌠
bbhse	쌡
bbhsx	쌢
bbhsw	쌣
bbho	쌤
bbha	쌥
bbhab	쌦
bbhb	쌧
bbhbb	쌨
bbhq	쌩
bbhu	쌪
bbhd	쌫
bbhz	쌬
bbhe	쌭
bbhx	쌮
bbhw	쌯
bbf	쌰
bbfy	쌱
bbfyy	쌲
bbfyb	쌳
bbfl	쌴
bbflu	쌵
bbflw	쌶
bbfc	쌷
bbfs	쌸
bbfsy	쌹
bbfso	쌺
bbfsa	쌻
bbfsb	쌼
bbfse	쌽
bbfsx	쌾
bbfsw	쌿
bbfo	썀
bbfa	썁
bbfab	썂
bbfb	썃
bbfbb	썄
bbfq	썅
bbfu	썆
bbfd	썇
bbfz	썈
bbfe	썉
bbfx	썊
bbfw	썋
vbh	썌
vbhy	썍
vbhyy	썎
vbhyb	썏
vbhl	썐
vbhlu	썑
vbhlw	썒
vbhc	썓
vbhs	썔
vbhsy	썕
vbhso	썖
vbhsa	썗
vbhsb	썘
vbhse	썙
vbhsx	썚
vbhsw	썛
vbho	썜
vbha	썝
vbhab	썞
vbhb	썟
vbhbb	썠
vbhq	썡
vbhu	썢
vbhd	썣
vbhz	썤
vbhe	썥
vbhx	썦
vbhw	썧
bbj	써
bbjy	썩
bbjyy	썪
bbjyb	썫
bbjl	썬
bbjlu	썭
bbjlw	썮
bbjc	썯
bbjs	썰
bbjsy	썱
bbjso	썲
bbjsa	썳
bbjsb	썴
bbjse	썵
bbjsx	썶
bbjsw	썷
bbjo	썸
bbja	썹
bbjab	썺
bbjb	썻
bbjbb	썼
bbjq	썽
bbju	썾
bbjd	썿
bbjz	쎀
bbje	쎁
bbjx	쎂
bbjw	쎃
bbp	쎄
bbpy	쎅
bbpyy	쎆
bbpyb	쎇
bbpl	쎈
bbplu	쎉
bbplw	쎊
bbpc	쎋
bbps	쎌
bbpsy	쎍
bbpso	쎎
bbpsa	쎏
bbpsb	쎐
bbpse	쎑
bbpsx	쎒
bbpsw	쎓
bbpo	쎔
bbpa	쎕
bbpab	쎖
bbpb	쎗
bbpbb	쎘
bbpq	쎙
bbpu	쎚
bbpd	쎛
bbpz	쎜
bbpe	쎝
bbpx	쎞
bbpw	쎟
bbg	쎠
bbgy	쎡
bbgyy	쎢
bbgyb	쎣
bbgl	쎤
bbglu	쎥
bbglw	쎦
bbgc	쎧
bbgs	쎨
bbgsy	쎩
bbgso	쎪
bbgsa	쎫
bbgsb	쎬
bbgse	쎭
bbgsx	쎮
bbgsw	쎯
bbgo	쎰
bbga	쎱
bbgab	쎲
bbgb	쎳
bbgbb	쎴
bbgq	쎵
bbgu	쎶
bbgd	쎷
bbgz	쎸
bbge	쎹
bbgx	쎺
bbgw	쎻
vbp	쎼
vbpy	쎽
vbpyy	쎾
vbpyb	쎿
vbpl	쏀
vbplu	쏁
vbplw	쏂
vbpc	쏃
vbps	쏄
vbpsy	쏅
vbpso	쏆
vbpsa	쏇
vbpsb	쏈
vbpse	쏉
vbpsx	쏊
vbpsw	쏋
vbpo	쏌
vbpa	쏍
vbpab	쏎
vbpb	쏏
vbpbb	쏐
vbpq	쏑
vbpu	쏒
vbpd	쏓
vbpz	쏔
vbpe	쏕
vbpx	쏖
vbpw	쏗
bbn	쏘
bbny	쏙
bbnyy	쏚
bbnyb	쏛
bbnl	쏜
bbnlu	쏝
bbnlw	쏞
bbnc	쏟
bbns	쏠
bbnsy	쏡
bbnso	쏢
bbnsa	쏣
bbnsb	쏤
bbnse	쏥
bbnsx	쏦
bbnsw	쏧
bbno	쏨
bbna	쏩
bbnab	쏪
bbnb	쏫
bbnbb	쏬
bbnq	쏭
bbnu	쏮
bbnd	쏯
bbnz	쏰
bbne	쏱
bbnx	쏲
bbnw	쏳
bbnk	쏴
bbnky	쏵
bbnkyy	쏶
bbnkyb	쏷
bbnkl	쏸
bbnklu	쏹
bbnklw	쏺
bbnkc	쏻
bbnks	쏼
bbnksy	쏽
bbnkso	쏾
bbnksa	쏿
#26
bbnksb	쐀
bbnkse	쐁
bbnksx	쐂
bbnksw	쐃
bbnko	쐄
bbnka	쐅
bbnkab	쐆
bbnkb	쐇
bbnkbb	쐈
bbnkq	쐉
bbnku	쐊
bbnkd	쐋
bbnkz	쐌
bbnke	쐍
bbnkx	쐎
bbnkw	쐏
bbnh	쐐
bbnhy	쐑
bbnhyy	쐒
bbnhyb	쐓
bbnhl	쐔
bbnhlu	쐕
bbnhlw	쐖
bbnhc	쐗
bbnhs	쐘
bbnhsy	쐙
bbnhso	쐚
bbnhsa	쐛
bbnhsb	쐜
bbnhse	쐝
bbnhsx	쐞
bbnhsw	쐟
bbnho	쐠
bbnha	쐡
bbnhab	쐢
bbnhb	쐣
bbnhbb	쐤
bbnhq	쐥
bbnhu	쐦
bbnhd	쐧
bbnhz	쐨
bbnhe	쐩
bbnhx	쐪
bbnhw	쐫
bbni	쐬
bbniy	쐭
bbniyy	쐮
bbniyb	쐯
bbnil	쐰
bbnilu	쐱
bbnilw	쐲
bbnic	쐳
bbnis	쐴
bbnisy	쐵
bbniso	쐶
bbnisa	쐷
bbnisb	쐸
bbnise	쐹
bbnisx	쐺
bbnisw	쐻
bbnio	쐼
bbnia	쐽
bbniab	쐾
bbnib	쐿
bbnibb	쑀
bbniq	쑁
bbniu	쑂
bbnid	쑃
bbniz	쑄
bbnie	쑅
bbnix	쑆
bbniw	쑇
bbm	쑈
bbmy	쑉
bbmyy	쑊
bbmyb	쑋
bbml	쑌
bbmlu	쑍
bbmlw	쑎
bbmc	쑏
bbms	쑐
bbmsy	쑑
bbmso	쑒
bbmsa	쑓
bbmsb	쑔
bbmse	쑕
bbmsx	쑖
bbmsw	쑗
bbmo	쑘
bbma	쑙
bbmab	쑚
bbmb	쑛
bbmbb	쑜
bbmq	쑝
bbmu	쑞
bbmd	쑟
bbmz	쑠
bbme	쑡
bbmx	쑢
bbmw	쑣
bbt	쑤
bbty	쑥
bbtyy	쑦
bbtyb	쑧
bbtl	쑨
bbtlu	쑩
bbtlw	쑪
bbtc	쑫
bbts	쑬
bbtsy	쑭
bbtso	쑮
bbtsa	쑯
bbtsb	쑰
bbtse	쑱
bbtsx	쑲
bbtsw	쑳
bbto	쑴
bbta	쑵
bbtab	쑶
bbtb	쑷
bbtbb	쑸
bbtq	쑹
bbtu	쑺
bbtd	쑻
bbtz	쑼
bbte	쑽
bbtx	쑾
bbtw	쑿
bbtj	쒀
bbtjy	쒁
bbtjyy	쒂
bbtjyb	쒃
bbtjl	쒄
bbtjlu	쒅
bbtjlw	쒆
bbtjc	쒇
bbtjs	쒈
bbtjsy	쒉
bbtjso	쒊
bbtjsa	쒋
bbtjsb	쒌
bbtjse	쒍
bbtjsx	쒎
bbtjsw	쒏
bbtjo	쒐
bbtja	쒑
bbtjab	쒒
bbtjb	쒓
bbtjbb	쒔
bbtjq	쒕
bbtju	쒖
bbtjd	쒗
bbtjz	쒘
bbtje	쒙
bbtjx	쒚
bbtjw	쒛
bbtp	쒜
bbtpy	쒝
bbtpyy	쒞
bbtpyb	쒟
bbtpl	쒠
bbtplu	쒡
bbtplw	쒢
bbtpc	쒣
bbtps	쒤
bbtpsy	쒥
bbtpso	쒦
bbtpsa	쒧
bbtpsb	쒨
bbtpse	쒩
bbtpsx	쒪
bbtpsw	쒫
bbtpo	쒬
bbtpa	쒭
bbtpab	쒮
bbtpb	쒯
bbtpbb	쒰
bbtpq	쒱
bbtpu	쒲
bbtpd	쒳
bbtpz	쒴
bbtpe	쒵
bbtpx	쒶
bbtpw	쒷
bbti	쒸
bbtiy	쒹
bbtiyy	쒺
bbtiyb	쒻
bbtil	쒼
bbtilu	쒽
bbtilw	쒾
bbtic	쒿
bbtis	쓀
bbtisy	쓁
bbtiso	쓂
bbtisa	쓃
bbtisb	쓄
bbtise	쓅
bbtisx	쓆
bbtisw	쓇
bbtio	쓈
bbtia	쓉
bbtiab	쓊
bbtib	쓋
bbtibb	쓌
bbtiq	쓍
bbtiu	쓎
bbtid	쓏
bbtiz	쓐
bbtie	쓑
bbtix	쓒
bbtiw	쓓
bbr	쓔
bbry	쓕
bbryy	쓖
bbryb	쓗
bbrl	쓘
bbrlu	쓙
bbrlw	쓚
bbrc	쓛
bbrs	쓜
bbrsy	쓝
bbrso	쓞
bbrsa	쓟
bbrsb	쓠
bbrse	쓡
bbrsx	쓢
bbrsw	쓣
bbro	쓤
bbra	쓥
bbrab	쓦
bbrb	쓧
bbrbb	쓨
bbrq	쓩
bbru	쓪
bbrd	쓫
bbrz	쓬
bbre	쓭
bbrx	쓮
bbrw	쓯
bbv	쓰
bbvy	쓱
bbvyy	쓲
bbvyb	쓳
bbvl	쓴
bbvlu	쓵
bbvlw	쓶
bbvc	쓷
bbvs	쓸
bbvsy	쓹
bbvso	쓺
bbvsa	쓻
bbvsb	쓼
bbvse	쓽
bbvsx	쓾
bbvsw	쓿
#27
bbvo	씀
bbva	씁
bbvab	씂
bbvb	씃
bbvbb	씄
bbvq	씅
bbvu	씆
bbvd	씇
bbvz	씈
bbve	씉
bbvx	씊
bbvw	씋
bbvi	씌
bbviy	씍
bbviyy	씎
bbviyb	씏
bbvil	씐
bbvilu	씑
bbvilw	씒
bbvic	씓
bbvis	씔
bbvisy	씕
bbviso	씖
bbvisa	씗
bbvisb	씘
bbvise	씙
bbvisx	씚
bbvisw	씛
bbvio	씜
bbvia	씝
bbviab	씞
bbvib	씟
bbvibb	씠
bbviq	씡
bbviu	씢
bbvid	씣
bbviz	씤
bbvie	씥
bbvix	씦
bbviw	씧
bbi	씨
bbiy	씩
bbiyy	씪
bbiyb	씫
bbil	씬
bbilu	씭
bbilw	씮
bbic	씯
bbis	씰
bbisy	씱
bbiso	씲
bbisa	씳
bbisb	씴
bbise	씵
bbisx	씶
bbisw	씷
bbio	씸
bbia	씹
bbiab	씺
bbib	씻
bbibb	씼
bbiq	씽
bbiu	씾
bbid	씿
bbiz	앀
bbie	앁
bbix	앂
bbiw	앃
qk	아
qky	악
qkyy	앆
qkyb	앇
qkl	안
qklu	앉
qklw	않
qkc	앋
qks	알
qksy	앍
qkso	앎
qksa	앏
qksb	앐
qkse	앑
qksx	앒
qksw	앓
qko	암
qka	압
qkab	앖
qkb	앗
qkbb	았
qkq	앙
qku	앚
qkd	앛
qkz	앜
qke	앝
qkx	앞
qkw	앟
qh	애
qhy	액
qhyy	앢
qhyb	앣
qhl	앤
qhlu	앥
qhlw	앦
qhc	앧
qhs	앨
qhsy	앩
qhso	앪
qhsa	앫
qhsb	앬
qhse	앭
qhsx	앮
qhsw	앯
qho	앰
qha	앱
qhab	앲
qhb	앳
qhbb	앴
qhq	앵
qhu	앶
qhd	앷
qhz	앸
qhe	앹
qhx	앺
qhw	앻
qf	야
qfy	약
qfyy	앾
qfyb	앿
qfl	얀
qflu	얁
qflw	얂
qfc	얃
qfs	얄
qfsy	얅
qfso	얆
qfsa	얇
qfsb	얈
qfse	얉
qfsx	얊
qfsw	얋
qfo	얌
qfa	얍
qfab	얎
qfb	얏
qfbb	얐
qfq	양
qfu	얒
qfd	얓
qfz	얔
qfe	얕
qfx	얖
qfw	얗
qhh	얘
qhhy	얙
qhhyy	얚
qhhyb	얛
qhhl	얜
qhhlu	얝
qhhlw	얞
qhhc	얟
qhhs	얠
qhhsy	얡
qhhso	얢
qhhsa	얣
qhhsb	얤
qhhse	얥
qhhsx	얦
qhhsw	얧
qhho	얨
qhha	얩
qhhab	얪
qhhb	얫
qhhbb	얬
qhhq	얭
qhhu	얮
qhhd	얯
qhhz	얰
qhhe	얱
qhhx	얲
qhhw	얳
qj	어
qjy	억
qjyy	얶
qjyb	얷
qjl	언
qjlu	얹
qjlw	얺
qjc	얻
qjs	얼
qjsy	얽
qjso	얾
qjsa	얿
qjsb	엀
qjse	엁
qjsx	엂
qjsw	엃
qjo	엄
qja	업
qjab	없
qjb	엇
qjbb	었
qjq	엉
qju	엊
qjd	엋
qjz	엌
qje	엍
qjx	엎
qjw	엏
qp	에
qpy	엑
qpyy	엒
qpyb	엓
qpl	엔
qplu	엕
qplw	엖
qpc	엗
qps	엘
qpsy	엙
qpso	엚
qpsa	엛
qpsb	엜
qpse	엝
qpsx	엞
qpsw	엟
qpo	엠
qpa	엡
qpab	엢
qpb	엣
qpbb	엤
qpq	엥
qpu	엦
qpd	엧
qpz	엨
qpe	엩
qpx	엪
qpw	엫
qg	여
qgy	역
qgyy	엮
qgyb	엯
qgl	연
qglu	엱
qglw	엲
qgc	엳
qgs	열
qgsy	엵
qgso	엶
qgsa	엷
qgsb	엸
qgse	엹
qgsx	엺
qgsw	엻
qgo	염
qga	엽
qgab	엾
qgb	엿
#28
qgbb	였
qgq	영
qgu	옂
qgd	옃
qgz	옄
qge	옅
qgx	옆
qgw	옇
qpp	예
qppy	옉
qppyy	옊
qppyb	옋
qppl	옌
qpplu	옍
qpplw	옎
qppc	옏
qpps	옐
qppsy	옑
qppso	옒
qppsa	옓
qppsb	옔
qppse	옕
qppsx	옖
qppsw	옗
qppo	옘
qppa	옙
qppab	옚
qppb	옛
qppbb	옜
qppq	옝
qppu	옞
qppd	옟
qppz	옠
qppe	옡
qppx	옢
qppw	옣
qn	오
qny	옥
qnyy	옦
qnyb	옧
qnl	온
qnlu	옩
qnlw	옪
qnc	옫
qns	올
qnsy	옭
qnso	옮
qnsa	옯
qnsb	옰
qnse	옱
qnsx	옲
qnsw	옳
qno	옴
qna	옵
qnab	옶
qnb	옷
qnbb	옸
qnq	옹
qnu	옺
qnd	옻
qnz	옼
qne	옽
qnx	옾
qnw	옿
qnk	와
qnky	왁
qnkyy	왂
qnkyb	왃
qnkl	완
qnklu	왅
qnklw	왆
qnkc	왇
qnks	왈
qnksy	왉
qnkso	왊
qnksa	왋
qnksb	왌
qnkse	왍
qnksx	왎
qnksw	왏
qnko	왐
qnka	왑
qnkab	왒
qnkb	왓
qnkbb	왔
qbkq	왕
qnku	왖
qnkd	왗
qnkz	왘
qnke	왙
qnkx	왚
qnkw	왛
qnh	왜
qnhy	왝
qnhyy	왞
qnhyb	왟
qnhl	왠
qnhlu	왡
qnhlw	왢
qnhc	왣
qnhs	왤
qnhsy	왥
qnhso	왦
qnhsa	왧
qnhsb	왨
qnhse	왩
qnhsx	왪
qnhsw	왫
qnho	왬
qnha	왭
qnhab	왮
qnhb	왯
qnhbb	왰
qnhq	왱
qnhu	왲
qnhd	왳
qnhz	왴
qnhe	왵
qnhx	왶
qnhw	왷
qni	외
qniy	왹
qniyy	왺
qniyb	왻
qnil	왼
qnilu	왽
qnilw	왾
qnic	왿
qnis	욀
qnisy	욁
qniso	욂
qnisa	욃
qnisb	욄
qnise	욅
qnisx	욆
qnisw	욇
qnio	욈
qnia	욉
qniab	욊
qnib	욋
qnibb	욌
qniq	욍
qniu	욎
qnid	욏
qniz	욐
qnie	욑
qnix	욒
qniw	욓
qm	요
qmy	욕
qmyy	욖
qmyb	욗
qml	욘
qmlu	욙
qmlw	욚
qmc	욛
qms	욜
qmsy	욝
qmso	욞
qmsa	욟
qmsb	욠
qmse	욡
qmsx	욢
qmsw	욣
qmo	욤
qma	욥
qmab	욦
qmb	욧
qmbb	욨
qmq	용
qmu	욪
qmd	욫
qmz	욬
qme	욭
qmx	욮
qmw	욯
qt	우
qty	욱
qtyy	욲
qtyb	욳
qtl	운
qtlu	욵
qtlw	욶
qtc	욷
qts	울
qtsy	욹
qtso	욺
qtsa	욻
qtsb	욼
qtse	욽
qtsx	욾
qtsw	욿
qto	움
qta	웁
qtab	웂
qtb	웃
qtbb	웄
qtq	웅
qtu	웆
qtd	웇
qtz	웈
qte	웉
qtx	웊
qtw	웋
qtj	워
qtjy	웍
qtjyy	웎
qtjyb	웏
qtjl	원
qtjlu	웑
qtjlw	웒
qtjc	웓
qtjs	월
qtjsy	웕
qtjso	웖
qtjsa	웗
qtjsb	웘
qtjse	웙
qtjsx	웚
qtjsw	웛
qtjo	웜
qtja	웝
qtjab	웞
qtjb	웟
qtjbb	웠
qtjq	웡
qtju	웢
qtjd	웣
qtjz	웤
qtje	웥
qtjx	웦
qtjw	웧
qtp	웨
qtpy	웩
qtpyy	웪
qtpyb	웫
qtpl	웬
qtplu	웭
qtplw	웮
qtpc	웯
qtps	웰
qtpsy	웱
qtpso	웲
qtpsa	웳
qtpsb	웴
qtpse	웵
qtpsx	웶
qtpsw	웷
qtpo	웸
qtpa	웹
qtpab	웺
qtpb	웻
qtpbb	웼
qtpq	웽
qtpu	웾
qtpd	웿
#29
qtpz	윀
qtpe	윁
qtpx	윂
qtpw	윃
qti	위
qtiy	윅
qtiyy	윆
qtiyb	윇
qtil	윈
qtilu	윉
qtilw	윊
qtic	윋
qtis	윌
qtisy	윍
qtiso	윎
qtisa	윏
qtisb	윐
qtise	윑
qtisx	윒
qtisw	윓
qtio	윔
qtia	윕
qtiab	윖
qtib	윗
qtibb	윘
qtiq	윙
qtiu	윚
qtid	윛
qtiz	윜
qtie	윝
qtix	윞
qtiw	윟
qr	유
qry	육
qryy	윢
qryb	윣
qrl	윤
qrlu	윥
qrlw	윦
qrc	윧
qrs	율
qrsy	윩
qrso	윪
qrsa	윫
qrsb	윬
qrse	윭
qrsx	윮
qrsw	윯
qro	윰
qra	윱
qrab	윲
qrb	윳
qrbb	윴
qrq	융
qru	윶
qrd	윷
qrz	윸
qre	윹
qrx	윺
qrw	윻
qv	으
qvy	윽
qvyy	윾
qvyb	윿
qvl	은
qvlu	읁
qvlw	읂
qvc	읃
qvs	을
qvsy	읅
qvso	읆
qvsa	읇
qvsb	읈
qvse	읉
qvsx	읊
qvsw	읋
qvo	음
qva	읍
qvab	읎
qvb	읏
qvbb	읐
qvq	응
qvu	읒
qvd	읓
qvz	읔
qve	읕
qvx	읖
qvw	읗
qvi	의
qviy	읙
qviyy	읚
qviyb	읛
qvil	읜
qvilu	읝
qvilw	읞
qvic	읟
qvis	읠
qvisy	읡
qviso	읢
qvisa	읣
qvisb	읤
qvise	읥
qvisx	읦
qvisw	읧
qvio	읨
qvia	읩
qviab	읪
qvib	읫
qvibb	읬
qviq	읭
qviu	읮
qvid	읯
qviz	읰
qvie	읱
qvix	읲
qviw	읳
qi	이
qiy	익
qiyy	읶
qiyb	읷
qil	인
qilu	읹
qilw	읺
qic	읻
qis	일
qisy	읽
qiso	읾
qisa	읿
qisb	잀
qise	잁
qisx	잂
qisw	잃
qio	임
qia	입
qiab	잆
qib	잇
qibb	있
qiq	잉
qiu	잊
qid	잋
qiz	잌
qie	잍
qix	잎
qiw	잏
uk	자
uky	작
ukyy	잒
ukyb	잓
ukl	잔
uklu	잕
uklw	잖
ukc	잗
uks	잘
uksy	잙
ukso	잚
uksa	잛
uksb	잜
ukse	잝
uksx	잞
uksw	잟
uko	잠
uka	잡
ukab	잢
ukb	잣
ukbb	잤
ukq	장
uku	잦
ukd	잧
ukz	잨
uke	잩
ukx	잪
ukw	잫
uh	재
uhy	잭
uhyy	잮
uhyb	잯
uhl	잰
uhlu	잱
uhlw	잲
uhc	잳
uhs	잴
uhsy	잵
uhso	잶
uhsa	잷
uhsb	잸
uhse	잹
uhsx	잺
uhsw	잻
uho	잼
uha	잽
uhab	잾
uhb	잿
uhbb	쟀
uhq	쟁
uhu	쟂
uhd	쟃
uhz	쟄
uhe	쟅
uhx	쟆
uhw	쟇
uf	쟈
ufy	쟉
ufyy	쟊
ufyb	쟋
ufl	쟌
uflu	쟍
uflw	쟎
ufc	쟏
ufs	쟐
ufsy	쟑
ufso	쟒
ufsa	쟓
ufsb	쟔
ufse	쟕
ufsx	쟖
ufsw	쟗
ufo	쟘
ufa	쟙
ufab	쟚
ufb	쟛
ufbb	쟜
ufq	쟝
ufu	쟞
ufd	쟟
ufz	쟠
ufe	쟡
ufx	쟢
ufw	쟣
uhh	쟤
uhhy	쟥
uhhyy	쟦
uhhyb	쟧
uhhl	쟨
uhhlu	쟩
uhhlw	쟪
uhhc	쟫
uhhs	쟬
uhhsy	쟭
uhhso	쟮
uhhsa	쟯
uhhsb	쟰
uhhse	쟱
uhhsx	쟲
uhhsw	쟳
uhho	쟴
uhha	쟵
uhhab	쟶
uhhb	쟷
uhhbb	쟸
uhhq	쟹
uhhu	쟺
uhhd	쟻
uhhz	쟼
uhhe	쟽
uhhx	쟾
uhhw	쟿
#30
uj	저
ujy	적
ujyy	젂
ujyb	젃
ujl	전
ujlu	젅
ujlw	젆
ujc	젇
ujs	절
ujsy	젉
ujso	젊
ujsa	젋
ujsb	젌
ujse	젍
ujsx	젎
ujsw	젏
ujo	점
uja	접
ujab	젒
ujb	젓
ujbb	젔
ujq	정
uju	젖
ujd	젗
ujz	젘
uje	젙
ujx	젚
ujw	젛
up	제
upy	젝
upyy	젞
upyb	젟
upl	젠
uplu	젡
uplw	젢
upc	젣
ups	젤
upsy	젥
upso	젦
upsa	젧
upsb	젨
upse	젩
upsx	젪
upsw	젫
upo	젬
upa	젭
upab	젮
upb	젯
upbb	젰
upq	젱
upu	젲
upd	젳
upz	젴
upe	젵
upx	젶
upw	젷
ug	져
ugy	젹
ugyy	젺
ugyb	젻
ugl	젼
uglu	젽
uglw	젾
ugc	젿
ugs	졀
ugsy	졁
ugso	졂
ugsa	졃
ugsb	졄
ugse	졅
ugsx	졆
ugsw	졇
ugo	졈
uga	졉
ugab	졊
ugb	졋
ugbb	졌
ugq	졍
ugu	졎
ugd	졏
ugz	졐
uge	졑
ugx	졒
ugw	졓
upp	졔
uppy	졕
uppyy	졖
uppyb	졗
uppl	졘
upplu	졙
upplw	졚
uppc	졛
upps	졜
uppsy	졝
uppso	졞
uppsa	졟
uppsb	졠
uppse	졡
uppsx	졢
uppsw	졣
uppo	졤
uppa	졥
uppab	졦
uppb	졧
uppbb	졨
uppq	졩
uppu	졪
uppd	졫
uppz	졬
uppe	졭
uppx	졮
uppw	졯
un	조
uny	족
unyy	졲
unyb	졳
unl	존
unlu	졵
unlw	졶
unc	졷
uns	졸
unsy	졹
unso	졺
unsa	졻
unsb	졼
unse	졽
unsx	졾
unsw	졿
uno	좀
una	좁
unab	좂
unb	좃
unbb	좄
unq	종
unu	좆
und	좇
unz	좈
une	좉
unx	좊
unw	좋
unk	좌
unky	좍
unkyy	좎
unkyb	좏
unkl	좐
unklu	좑
unklw	좒
unkc	좓
unks	좔
unksy	좕
unkso	좖
unksa	좗
unksb	좘
unkse	좙
unksx	좚
unksw	좛
unko	좜
unka	좝
unkab	좞
unkb	좟
unkbb	좠
unkq	좡
unku	좢
unkd	좣
unkz	좤
unke	좥
unkx	좦
unkw	좧
unh	좨
unhy	좩
unhyy	좪
unhyb	좫
unhl	좬
unhlu	좭
unhlw	좮
unhc	좯
unhs	좰
unhsy	좱
unhso	좲
unhsa	좳
unhsb	좴
unhse	좵
unhsx	좶
unhsw	좷
unho	좸
unha	좹
unhab	좺
unhb	좻
unhbb	좼
unhq	좽
unhu	좾
unhd	좿
unhz	죀
unhe	죁
unhx	죂
unhw	죃
uni	죄
uniy	죅
uniyy	죆
uniyb	죇
unil	죈
unilu	죉
unilw	죊
unic	죋
unis	죌
unisy	죍
uniso	죎
unisa	죏
unisb	죐
unise	죑
unisx	죒
unisw	죓
unio	죔
unia	죕
uniab	죖
unib	죗
unibb	죘
uniq	죙
uniu	죚
unid	죛
uniz	죜
unie	죝
unix	죞
uniw	죟
um	죠
umy	죡
umyy	죢
umyb	죣
uml	죤
umlu	죥
umlw	죦
umc	죧
ums	죨
umsy	죩
umso	죪
umsa	죫
umsb	죬
umse	죭
umsx	죮
umsw	죯
umo	죰
uma	죱
umab	죲
umb	죳
umbb	죴
umq	죵
umu	죶
umd	죷
umz	죸
ume	죹
umx	죺
umw	죻
ut	주
uty	죽
utyy	죾
utyb	죿
#31
utl	준
utlu	줁
utlw	줂
utc	줃
uts	줄
utsy	줅
utso	줆
utsa	줇
utsb	줈
utse	줉
utsx	줊
utsw	줋
uto	줌
uta	줍
utab	줎
utb	줏
utbb	줐
utq	중
utu	줒
utd	줓
utz	줔
ute	줕
utx	줖
utw	줗
utj	줘
utjy	줙
utjyy	줚
utjyb	줛
utjl	줜
utjlu	줝
utjlw	줞
utjc	줟
utjs	줠
utjsy	줡
utjso	줢
utjsa	줣
utjsb	줤
utjse	줥
utjsx	줦
utjsw	줧
utjo	줨
utja	줩
utjab	줪
utjb	줫
utjbb	줬
utjq	줭
utju	줮
utjd	줯
utjz	줰
utje	줱
utjx	줲
utjw	줳
utp	줴
utpy	줵
utpyy	줶
utpyb	줷
utpl	줸
utplu	줹
utplw	줺
utpc	줻
utps	줼
utpsy	줽
utpso	줾
utpsa	줿
utpsb	쥀
utpse	쥁
utpsx	쥂
utpsw	쥃
utpo	쥄
utpa	쥅
utpab	쥆
utpb	쥇
utpbb	쥈
utpq	쥉
utpu	쥊
utpd	쥋
utpz	쥌
utpe	쥍
utpx	쥎
utpw	쥏
uti	쥐
utiy	쥑
utiyy	쥒
utiyb	쥓
util	쥔
utilu	쥕
utilw	쥖
utic	쥗
utis	쥘
utisy	쥙
utiso	쥚
utisa	쥛
utisb	쥜
utise	쥝
utisx	쥞
utisw	쥟
utio	쥠
utia	쥡
utiab	쥢
utib	쥣
utibb	쥤
utiq	쥥
utiu	쥦
utid	쥧
utiz	쥨
utie	쥩
utix	쥪
utiw	쥫
ur	쥬
ury	쥭
uryy	쥮
uryb	쥯
url	쥰
urlu	쥱
urlw	쥲
urc	쥳
urs	쥴
ursy	쥵
urso	쥶
ursa	쥷
ursb	쥸
urse	쥹
ursx	쥺
ursw	쥻
uro	쥼
ura	쥽
urab	쥾
urb	쥿
urbb	즀
urq	즁
uru	즂
urd	즃
urz	즄
ure	즅
urx	즆
urw	즇
uv	즈
uvy	즉
uvyy	즊
uvyb	즋
uvl	즌
uvlu	즍
uvlw	즎
uvc	즏
uvs	즐
uvsy	즑
uvso	즒
uvsa	즓
uvsb	즔
uvse	즕
uvsx	즖
uvsw	즗
uvo	즘
uva	즙
uvab	즚
uvb	즛
uvbb	즜
uvq	증
uvu	즞
uvd	즟
uvz	즠
uve	즡
uvx	즢
uvw	즣
uvi	즤
uviy	즥
uviyy	즦
uviyb	즧
uvil	즨
uvilu	즩
uvilw	즪
uvic	즫
uvis	즬
uvisy	즭
uviso	즮
uvisa	즯
uvisb	즰
uvise	즱
uvisx	즲
uvisw	즳
uvio	즴
uvia	즵
uviab	즶
uvib	즷
uvibb	즸
uviq	즹
uviu	즺
uvid	즻
uviz	즼
uvie	즽
uvix	즾
uviw	즿
ui	지
uiy	직
uiyy	짂
uiyb	짃
uil	진
uilu	짅
uilw	짆
uic	짇
uis	질
uisy	짉
uiso	짊
uisa	짋
uisb	짌
uise	짍
uisx	짎
uisw	짏
uio	짐
uia	집
uiab	짒
uib	짓
uibb	짔
uiq	징
uiu	짖
uid	짗
uiz	짘
uie	짙
uix	짚
uiw	짛
uuk	짜
uuky	짝
uukyy	짞
uukyb	짟
uukl	짠
uuklu	짡
uuklw	짢
uukc	짣
uuks	짤
uuksy	짥
uukso	짦
uuksa	짧
uuksb	짨
uukse	짩
uuksx	짪
uuksw	짫
uuko	짬
uuka	짭
uukab	짮
uukb	짯
uukbb	짰
uukq	짱
uuku	짲
uukd	짳
uukz	짴
uuke	짵
uukx	짶
uukw	짷
uuh	째
uuhy	짹
uuhyy	짺
uuhyb	짻
uuhl	짼
uuhlu	짽
uuhlw	짾
uuhc	짿
#32
uuhs	쨀
uuhsy	쨁
uuhso	쨂
uuhsa	쨃
uuhsb	쨄
uuhse	쨅
uuhsx	쨆
uuhsw	쨇
uuho	쨈
uuha	쨉
uuhab	쨊
uuhb	쨋
uuhbb	쨌
uuhq	쨍
uuhu	쨎
uuhd	쨏
uuhz	쨐
uuhe	쨑
uuhx	쨒
uuhw	쨓
uuf	쨔
uufy	쨕
uufyy	쨖
uufyb	쨗
uufl	쨘
uuflu	쨙
uuflw	쨚
uufc	쨛
uufs	쨜
uufsy	쨝
uufso	쨞
uufsa	쨟
uufsb	쨠
uufse	쨡
uufsx	쨢
uufsw	쨣
uufo	쨤
uufa	쨥
uufab	쨦
uufb	쨧
uufbb	쨨
uufq	쨩
uufu	쨪
uufd	쨫
uufz	쨬
uufe	쨭
uufx	쨮
uufw	쨯
vuh	쨰
vuhy	쨱
vuhyy	쨲
vuhyb	쨳
vuhl	쨴
vuhlu	쨵
vuhlw	쨶
vuhc	쨷
vuhs	쨸
vuhsy	쨹
vuhso	쨺
vuhsa	쨻
vuhsb	쨼
vuhse	쨽
vuhsx	쨾
vuhsw	쨿
vuho	쩀
vuha	쩁
vuhab	쩂
vuhb	쩃
vuhbb	쩄
vuhq	쩅
vuhu	쩆
vuhd	쩇
vuhz	쩈
vuhe	쩉
vuhx	쩊
vuhw	쩋
uuj	쩌
uujy	쩍
uujyy	쩎
uujyb	쩏
uujl	쩐
uujlu	쩑
uujlw	쩒
uujc	쩓
uujs	쩔
uujsy	쩕
uujso	쩖
uujsa	쩗
uujsb	쩘
uujse	쩙
uujsx	쩚
uujsw	쩛
uujo	쩜
uuja	쩝
uujab	쩞
uujb	쩟
uujbb	쩠
uujq	쩡
uuju	쩢
uujd	쩣
uujz	쩤
uuje	쩥
uujx	쩦
uujw	쩧
uup	쩨
uupy	쩩
uupyy	쩪
uupyb	쩫
uupl	쩬
uuplu	쩭
uuplw	쩮
uupc	쩯
uups	쩰
uupsy	쩱
uupso	쩲
uupsa	쩳
uupsb	쩴
uupse	쩵
uupsx	쩶
uupsw	쩷
uupo	쩸
uupa	쩹
uupab	쩺
uupb	쩻
uupbb	쩼
uupq	쩽
uupu	쩾
uupd	쩿
uupz	쪀
uupe	쪁
uupx	쪂
uupw	쪃
uug	쪄
uugy	쪅
uugyy	쪆
uugyb	쪇
uugl	쪈
uuglu	쪉
uuglw	쪊
uugc	쪋
uugs	쪌
uugsy	쪍
uugso	쪎
uugsa	쪏
uugsb	쪐
uugse	쪑
uugsx	쪒
uugsw	쪓
uugo	쪔
uuga	쪕
uugab	쪖
uugb	쪗
uugbb	쪘
uugq	쪙
uugu	쪚
uugd	쪛
uugz	쪜
uuge	쪝
uugx	쪞
uugw	쪟
vup	쪠
vupy	쪡
vupyy	쪢
vupyb	쪣
vupl	쪤
vuplu	쪥
vuplw	쪦
vupc	쪧
vups	쪨
vupsy	쪩
vupso	쪪
vupsa	쪫
vupsb	쪬
vupse	쪭
vupsx	쪮
vupsw	쪯
vupo	쪰
vupa	쪱
vupab	쪲
vupb	쪳
vupbb	쪴
vupq	쪵
vupu	쪶
vupd	쪷
vupz	쪸
vupe	쪹
vupx	쪺
vupw	쪻
uun	쪼
uuny	쪽
uunyy	쪾
uunyb	쪿
uunl	쫀
uunlu	쫁
uunlw	쫂
uunc	쫃
uuns	쫄
uunsy	쫅
uunso	쫆
uunsa	쫇
uunsb	쫈
uunse	쫉
uunsx	쫊
uunsw	쫋
uuno	쫌
uuna	쫍
uunab	쫎
uunb	쫏
uunbb	쫐
uunq	쫑
uunu	쫒
uund	쫓
uunz	쫔
uune	쫕
uunx	쫖
uunw	쫗
uunk	쫘
uunky	쫙
uunkyy	쫚
uunkyb	쫛
uunkl	쫜
uunklu	쫝
uunklw	쫞
uunkc	쫟
uunks	쫠
uunksy	쫡
uunkso	쫢
uunksa	쫣
uunksb	쫤
uunkse	쫥
uunksx	쫦
uunksw	쫧
uunko	쫨
uunka	쫩
uunkab	쫪
uunkb	쫫
uunkbb	쫬
uunkq	쫭
uunku	쫮
uunkd	쫯
uunkz	쫰
uunke	쫱
uunkx	쫲
uunkw	쫳
uunh	쫴
uunhy	쫵
uunhyy	쫶
uunhyb	쫷
uunhl	쫸
uunhlu	쫹
uunhlw	쫺
uunhc	쫻
uunhs	쫼
uunhsy	쫽
uunhso	쫾
uunhsa	쫿
#33
uunhsb	쬀
uunhse	쬁
uunhsx	쬂
uunhsw	쬃
uunho	쬄
uunha	쬅
uunhab	쬆
uunhb	쬇
uunhbb	쬈
uunhq	쬉
uunhu	쬊
uunhd	쬋
uunhz	쬌
uunhe	쬍
uunhx	쬎
uunhw	쬏
uuni	쬐
uuniy	쬑
uuniyy	쬒
uuniyb	쬓
uunil	쬔
uunilu	쬕
uunilw	쬖
uunic	쬗
uunis	쬘
uunisy	쬙
uuniso	쬚
uunisa	쬛
uunisb	쬜
uunise	쬝
uunisx	쬞
uunisw	쬟
uunio	쬠
uunia	쬡
uuniab	쬢
uunib	쬣
uunibb	쬤
uuniq	쬥
uuniu	쬦
uunid	쬧
uuniz	쬨
uunie	쬩
uunix	쬪
uuniw	쬫
uum	쬬
uumy	쬭
uumyy	쬮
uumyb	쬯
uuml	쬰
uumlu	쬱
uumlw	쬲
uumc	쬳
uums	쬴
uumsy	쬵
uumso	쬶
uumsa	쬷
uumsb	쬸
uumse	쬹
uumsx	쬺
uumsw	쬻
uumo	쬼
uuma	쬽
uumab	쬾
uumb	쬿
uumbb	쭀
uumq	쭁
uumu	쭂
uumd	쭃
uumz	쭄
uume	쭅
uumx	쭆
uumw	쭇
uut	쭈
uuty	쭉
uutyy	쭊
uutyb	쭋
uutl	쭌
uutlu	쭍
uutlw	쭎
uutc	쭏
uuts	쭐
uutsy	쭑
uutso	쭒
uutsa	쭓
uutsb	쭔
uutse	쭕
uutsx	쭖
uutsw	쭗
uuto	쭘
uuta	쭙
uutab	쭚
uutb	쭛
uutbb	쭜
uutq	쭝
uutu	쭞
uutd	쭟
uutz	쭠
uute	쭡
uutx	쭢
uutw	쭣
uutj	쭤
uutjy	쭥
uutjyy	쭦
uutjyb	쭧
uutjl	쭨
uutjlu	쭩
uutjlw	쭪
uutjc	쭫
uutjs	쭬
uutjsy	쭭
uutjso	쭮
uutjsa	쭯
uutjsb	쭰
uutjse	쭱
uutjsx	쭲
uutjsw	쭳
uutjo	쭴
uutja	쭵
uutjab	쭶
uutjb	쭷
uutjbb	쭸
uutjq	쭹
uutju	쭺
uutjd	쭻
uutjz	쭼
uutje	쭽
uutjx	쭾
uutjw	쭿
uutp	쮀
uutpy	쮁
uutpyy	쮂
uutpyb	쮃
uutpl	쮄
uutplu	쮅
uutplw	쮆
uutpc	쮇
uutps	쮈
uutpsy	쮉
uutpso	쮊
uutpsa	쮋
uutpsb	쮌
uutpse	쮍
uutpsx	쮎
uutpsw	쮏
uutpo	쮐
uutpa	쮑
uutpab	쮒
uutpb	쮓
uutpbb	쮔
uutpq	쮕
uutpu	쮖
uutpd	쮗
uutpz	쮘
uutpe	쮙
uutpx	쮚
uutpw	쮛
uuti	쮜
uutiy	쮝
uutiyy	쮞
uutiyb	쮟
uutil	쮠
uutilu	쮡
uutilw	쮢
uutic	쮣
uutis	쮤
uutisy	쮥
uutiso	쮦
uutisa	쮧
uutisb	쮨
uutise	쮩
uutisx	쮪
uutisw	쮫
uutio	쮬
uutia	쮭
uutiab	쮮
uutib	쮯
uutibb	쮰
uutiq	쮱
uutiu	쮲
uutid	쮳
uutiz	쮴
uutie	쮵
uutix	쮶
uutiw	쮷
uur	쮸
uury	쮹
uuryy	쮺
uuryb	쮻
uurl	쮼
uurlu	쮽
uurlw	쮾
uurc	쮿
uurs	쯀
uursy	쯁
uurso	쯂
uursa	쯃
uursb	쯄
uurse	쯅
uursx	쯆
uursw	쯇
uuro	쯈
uura	쯉
uurab	쯊
uurb	쯋
uurbb	쯌
uurq	쯍
uuru	쯎
uurd	쯏
uurz	쯐
uure	쯑
uurx	쯒
uurw	쯓
uuv	쯔
uuvy	쯕
uuvyy	쯖
uuvyb	쯗
uuvl	쯘
uuvlu	쯙
uuvlw	쯚
uuvc	쯛
uuvs	쯜
uuvsy	쯝
uuvso	쯞
uuvsa	쯟
uuvsb	쯠
uuvse	쯡
uuvsx	쯢
uuvsw	쯣
uuvo	쯤
uuva	쯥
uuvab	쯦
uuvb	쯧
uuvbb	쯨
uuvq	쯩
uuvu	쯪
uuvd	쯫
uuvz	쯬
uuve	쯭
uuvx	쯮
uuvw	쯯
uuvi	쯰
uuviy	쯱
uuviyy	쯲
uuviyb	쯳
uuvil	쯴
uuvilu	쯵
uuvilw	쯶
uuvic	쯷
uuvis	쯸
uuvisy	쯹
uuviso	쯺
uuvisa	쯻
uuvisb	쯼
uuvise	쯽
uuvisx	쯾
uuvisw	쯿
#34
uuvio	찀
uuvia	찁
uuviab	찂
uuvib	찃
uuvibb	찄
uuviq	찅
uuviu	찆
uuvid	찇
uuviz	찈
uuvie	찉
uuvix	찊
uuviw	찋
uui	찌
uuiy	찍
uuiyy	찎
uuiyb	찏
uuil	찐
uuilu	찑
uuilw	찒
uuic	찓
uuis	찔
uuisy	찕
uuiso	찖
uuisa	찗
uuisb	찘
uuise	찙
uuisx	찚
uuisw	찛
uuio	찜
uuia	찝
uuiab	찞
uuib	찟
uuibb	찠
uuiq	찡
uuiu	찢
uuid	찣
uuiz	찤
uuie	찥
uuix	찦
uuiw	찧
dk	차
dky	착
dkyy	찪
dkyb	찫
dkl	찬
dklu	찭
dklw	찮
dkc	찯
dks	찰
dksy	찱
dkso	찲
dksa	찳
dksb	찴
dkse	찵
dksx	찶
dksw	찷
dko	참
dka	찹
dkab	찺
dkb	찻
dkbb	찼
dkq	창
dku	찾
dkd	찿
dkz	챀
dke	챁
dkx	챂
dkw	챃
dh	채
dhy	책
dhyy	챆
dhyb	챇
dhl	챈
dhlu	챉
dhlw	챊
dhc	챋
dhs	챌
dhsy	챍
dhso	챎
dhsa	챏
dhsb	챐
dhse	챑
dhsx	챒
dhsw	챓
dho	챔
dha	챕
dhab	챖
dhb	챗
dhbb	챘
dhq	챙
dhu	챚
dhd	챛
dhz	챜
dhe	챝
dhx	챞
dhw	챟
df	챠
dfy	챡
dfyy	챢
dfyb	챣
dfl	챤
dflu	챥
dflw	챦
dfc	챧
dfs	챨
dfsy	챩
dfso	챪
dfsa	챫
dfsb	챬
dfse	챭
dfsx	챮
dfsw	챯
dfo	챰
dfa	챱
dfab	챲
dfb	챳
dfbb	챴
dfq	챵
dfu	챶
dfd	챷
dfz	챸
dfe	챹
dfx	챺
dfw	챻
dhh	챼
dhhy	챽
dhhyy	챾
dhhyb	챿
dhhl	첀
dhhlu	첁
dhhlw	첂
dhhc	첃
dhhs	첄
dhhsy	첅
dhhso	첆
dhhsa	첇
dhhsb	첈
dhhse	첉
dhhsx	첊
dhhsw	첋
dhho	첌
dhha	첍
dhhab	첎
dhhb	첏
dhhbb	첐
dhhq	첑
dhhu	첒
dhhd	첓
dhhz	첔
dhhe	첕
dhhx	첖
dhhw	첗
dj	처
djy	척
djyy	첚
djyb	첛
djl	천
djlu	첝
djlw	첞
djc	첟
djs	철
djsy	첡
djso	첢
djsa	첣
djsb	첤
djse	첥
djsx	첦
djsw	첧
djo	첨
dja	첩
djab	첪
djb	첫
djbb	첬
djq	청
dju	첮
djd	첯
djz	첰
dje	첱
djx	첲
djw	첳
dp	체
dpy	첵
dpyy	첶
dpyb	첷
dpl	첸
dplu	첹
dplw	첺
dpc	첻
dps	첼
dpsy	첽
dpso	첾
dpsa	첿
dpsb	쳀
dpse	쳁
dpsx	쳂
dpsw	쳃
dpo	쳄
dpa	쳅
dpab	쳆
dpb	쳇
dpbb	쳈
dpq	쳉
dpu	쳊
dpd	쳋
dpz	쳌
dpe	쳍
dpx	쳎
dpw	쳏
dg	쳐
dgy	쳑
dgyy	쳒
dgyb	쳓
dgl	쳔
dglu	쳕
dglw	쳖
dgc	쳗
dgs	쳘
dgsy	쳙
dgso	쳚
dgsa	쳛
dgsb	쳜
dgse	쳝
dgsx	쳞
dgsw	쳟
dgo	쳠
dga	쳡
dgab	쳢
dgb	쳣
dgbb	쳤
dgq	쳥
dgu	쳦
dgd	쳧
dgz	쳨
dge	쳩
dgx	쳪
dgw	쳫
dpp	쳬
dppy	쳭
dppyy	쳮
dppyb	쳯
dppl	쳰
dpplu	쳱
dpplw	쳲
dppc	쳳
dpps	쳴
dppsy	쳵
dppso	쳶
dppsa	쳷
dppsb	쳸
dppse	쳹
dppsx	쳺
dppsw	쳻
dppo	쳼
dppa	쳽
dppab	쳾
dppb	쳿
#35
dppbb	촀
dppq	촁
dppu	촂
dppd	촃
dppz	촄
dppe	촅
dppx	촆
dppw	촇
dn	초
dny	촉
dnyy	촊
dnyb	촋
dnl	촌
dnlu	촍
dnlw	촎
dnc	촏
dns	촐
dnsy	촑
dnso	촒
dnsa	촓
dnsb	촔
dnse	촕
dnsx	촖
dnsw	촗
dno	촘
dna	촙
dnab	촚
dnb	촛
dnbb	촜
dnq	총
dnu	촞
dnd	촟
dnz	촠
dne	촡
dnx	촢
dnw	촣
dnk	촤
dnky	촥
dnkyy	촦
dnkyb	촧
dnkl	촨
dnklu	촩
dnklw	촪
dnkc	촫
dnks	촬
dnksy	촭
dnkso	촮
dnksa	촯
dnksb	촰
dnkse	촱
dnksx	촲
dnksw	촳
dnko	촴
dnka	촵
dnkab	촶
dnkb	촷
dnkbb	촸
dnkq	촹
dnku	촺
dnkd	촻
dnkz	촼
dnke	촽
dnkx	촾
dnkw	촿
dnh	쵀
dnhy	쵁
dnhyy	쵂
dnhyb	쵃
dnhl	쵄
dnhlu	쵅
dnhlw	쵆
dnhc	쵇
dnhs	쵈
dnhsy	쵉
dnhso	쵊
dnhsa	쵋
dnhsb	쵌
dnhse	쵍
dnhsx	쵎
dnhsw	쵏
dnho	쵐
dnha	쵑
dnhab	쵒
dnhb	쵓
dnhbb	쵔
dnhq	쵕
dnhu	쵖
dnhd	쵗
dnhz	쵘
dnhe	쵙
dnhx	쵚
dnhw	쵛
dni	최
dniy	쵝
dniyy	쵞
dniyb	쵟
dnil	쵠
dnilu	쵡
dnilw	쵢
dnic	쵣
dnis	쵤
dnisy	쵥
dniso	쵦
dnisa	쵧
dnisb	쵨
dnise	쵩
dnisx	쵪
dnisw	쵫
dnio	쵬
dnia	쵭
dniab	쵮
dnib	쵯
dnibb	쵰
dniq	쵱
dniu	쵲
dnid	쵳
dniz	쵴
dnie	쵵
dnix	쵶
dniw	쵷
dm	쵸
dmy	쵹
dmyy	쵺
dmyb	쵻
dml	쵼
dmlu	쵽
dmlw	쵾
dmc	쵿
dms	춀
dmsy	춁
dmso	춂
dmsa	춃
dmsb	춄
dmse	춅
dmsx	춆
dmsw	춇
dmo	춈
dma	춉
dmab	춊
dmb	춋
dmbb	춌
dmq	춍
dmu	춎
dmd	춏
dmz	춐
dme	춑
dmx	춒
dmw	춓
dt	추
dty	축
dtyy	춖
dtyb	춗
dtl	춘
dtlu	춙
dtlw	춚
dtc	춛
dts	출
dtsy	춝
dtso	춞
dtsa	춟
dtsb	춠
dtse	춡
dtsx	춢
dtsw	춣
dto	춤
dta	춥
dtab	춦
dtb	춧
dtbb	춨
dtq	충
dtu	춪
dtd	춫
dtz	춬
dte	춭
dtx	춮
dtw	춯
dtj	춰
dtjy	춱
dtjyy	춲
dtjyb	춳
dtjl	춴
dtjlu	춵
dtjlw	춶
dtjc	춷
dtjs	춸
dtjsy	춹
dtjso	춺
dtjsa	춻
dtjsb	춼
dtjse	춽
dtjsx	춾
dtjsw	춿
dtjo	췀
dtja	췁
dtjab	췂
dtjb	췃
dtjbb	췄
dtjq	췅
dtju	췆
dtjd	췇
dtjz	췈
dtje	췉
dtjx	췊
dtjw	췋
dtp	췌
dtpy	췍
dtpyy	췎
dtpyb	췏
dtpl	췐
dtplu	췑
dtplw	췒
dtpc	췓
dtps	췔
dtpsy	췕
dtpso	췖
dtpsa	췗
dtpsb	췘
dtpse	췙
dtpsx	췚
dtpsw	췛
dtpo	췜
dtpa	췝
dtpab	췞
dtpb	췟
dtpbb	췠
dtpq	췡
dtpu	췢
dtpd	췣
dtpz	췤
dtpe	췥
dtpx	췦
dtpw	췧
dti	취
dtiy	췩
dtiyy	췪
dtiyb	췫
dtil	췬
dtilu	췭
dtilw	췮
dtic	췯
dtis	췰
dtisy	췱
dtiso	췲
dtisa	췳
dtisb	췴
dtise	췵
dtisx	췶
dtisw	췷
dtio	췸
dtia	췹
dtiab	췺
dtib	췻
dtibb	췼
dtiq	췽
dtiu	췾
dtid	췿
#36
dtiz	츀
dtie	츁
dtix	츂
dtiw	츃
dr	츄
dry	츅
dryy	츆
dryb	츇
drl	츈
drlu	츉
drlw	츊
drc	츋
drs	츌
drsy	츍
drso	츎
drsa	츏
drsb	츐
drse	츑
drsx	츒
drsw	츓
dro	츔
dra	츕
drab	츖
drb	츗
drbb	츘
drq	츙
dru	츚
drd	츛
drz	츜
dre	츝
drx	츞
drw	츟
dv	츠
dvy	측
dvyy	츢
dvyb	츣
dvl	츤
dvlu	츥
dvlw	츦
dvc	츧
dvs	츨
dvsy	츩
dvso	츪
dvsa	츫
dvsb	츬
dvse	츭
dvsx	츮
dvsw	츯
dvo	츰
dva	츱
dvab	츲
dvb	츳
dvbb	츴
dvq	층
dvu	츶
dvd	츷
dvz	츸
dve	츹
dvx	츺
dvw	츻
dvi	츼
dviy	츽
dviyy	츾
dviyb	츿
dvil	칀
dvilu	칁
dvilw	칂
dvic	칃
dvis	칄
dvisy	칅
dviso	칆
dvisa	칇
dvisb	칈
dvise	칉
dvisx	칊
dvisw	칋
dvio	칌
dvia	칍
dviab	칎
dvib	칏
dvibb	칐
dviq	칑
dviu	칒
dvid	칓
dviz	칔
dvie	칕
dvix	칖
dviw	칗
di	치
diy	칙
diyy	칚
diyb	칛
dil	친
dilu	칝
dilw	칞
dic	칟
dis	칠
disy	칡
diso	칢
disa	칣
disb	칤
dise	칥
disx	칦
disw	칧
dio	침
dia	칩
diab	칪
dib	칫
dibb	칬
diq	칭
diu	칮
did	칯
diz	칰
die	칱
dix	칲
diw	칳
zk	카
zky	칵
zkyy	칶
zkyb	칷
zkl	칸
zklu	칹
zklw	칺
zkc	칻
zks	칼
zksy	칽
zkso	칾
zksa	칿
zksb	캀
zkse	캁
zksx	캂
zksw	캃
zko	캄
zka	캅
zkab	캆
zkb	캇
zkbb	캈
zkq	캉
zku	캊
zkd	캋
zkz	캌
zke	캍
zkx	캎
zkw	캏
zh	캐
zhy	캑
zhyy	캒
zhyb	캓
zhl	캔
zhlu	캕
zhlw	캖
zhc	캗
zhs	캘
zhsy	캙
zhso	캚
zhsa	캛
zhsb	캜
zhse	캝
zhsx	캞
zhsw	캟
zho	캠
zha	캡
zhab	캢
zhb	캣
zhbb	캤
zhq	캥
zhu	캦
zhd	캧
zhz	캨
zhe	캩
zhx	캪
zhw	캫
zf	캬
zfy	캭
zfyy	캮
zfyb	캯
zfl	캰
zflu	캱
zflw	캲
zfc	캳
zfs	캴
zfsy	캵
zfso	캶
zfsa	캷
zfsb	캸
zfse	캹
zfsx	캺
zfsw	캻
zfo	캼
zfa	캽
zfab	캾
zfb	캿
zfbb	컀
zfq	컁
zfu	컂
zfd	컃
zfz	컄
zfe	컅
zfx	컆
zfw	컇
zhh	컈
zhhy	컉
zhhyy	컊
zhhyb	컋
zhhl	컌
zhhlu	컍
zhhlw	컎
zhhc	컏
zhhs	컐
zhhsy	컑
zhhso	컒
zhhsa	컓
zhhsb	컔
zhhse	컕
zhhsx	컖
zhhsw	컗
zhho	컘
zhha	컙
zhhab	컚
zhhb	컛
zhhbb	컜
zhhq	컝
zhhu	컞
zhhd	컟
zhhz	컠
zhhe	컡
zhhx	컢
zhhw	컣
zj	커
zjy	컥
zjyy	컦
zjyb	컧
zjl	컨
zjlu	컩
zjlw	컪
zjc	컫
zjs	컬
zjsy	컭
zjso	컮
zjsa	컯
zjsb	컰
zjse	컱
zjsx	컲
zjsw	컳
zjo	컴
zja	컵
zjab	컶
zjb	컷
zjbb	컸
zjq	컹
zju	컺
zjd	컻
zjz	컼
zje	컽
zjx	컾
zjw	컿
#37
zp	케
zpy	켁
zpyy	켂
zpyb	켃
zpl	켄
zplu	켅
zplw	켆
zpc	켇
zps	켈
zpsy	켉
zpso	켊
zpsa	켋
zpsb	켌
zpse	켍
zpsx	켎
zpsw	켏
zpo	켐
zpa	켑
zpab	켒
zpb	켓
zpbb	켔
zpq	켕
zpu	켖
zpd	켗
zpz	켘
zpe	켙
zpx	켚
zpw	켛
zg	켜
zgy	켝
zgyy	켞
zgyb	켟
zgl	켠
zglu	켡
zglw	켢
zgc	켣
zgs	켤
zgsy	켥
zgso	켦
zgsa	켧
zgsb	켨
zgse	켩
zgsx	켪
zgsw	켫
zgo	켬
zga	켭
zgab	켮
zgb	켯
zgbb	켰
zgq	켱
zgu	켲
zgd	켳
zgz	켴
zge	켵
zgx	켶
zgw	켷
zpp	켸
zppy	켹
zppyy	켺
zppyb	켻
zppl	켼
zpplu	켽
zpplw	켾
zppc	켿
zpps	콀
zppsy	콁
zppso	콂
zppsa	콃
zppsb	콄
zppse	콅
zppsx	콆
zppsw	콇
zppo	콈
zppa	콉
zppab	콊
zppb	콋
zppbb	콌
zppq	콍
zppu	콎
zppd	콏
zppz	콐
zppe	콑
zppx	콒
zppw	콓
zn	코
zny	콕
znyy	콖
znyb	콗
znl	콘
znlu	콙
znlw	콚
znc	콛
zns	콜
znsy	콝
znso	콞
znsa	콟
znsb	콠
znse	콡
znsx	콢
znsw	콣
zno	콤
zna	콥
znab	콦
znb	콧
znbb	콨
znq	콩
znu	콪
znd	콫
znz	콬
zne	콭
znx	콮
znw	콯
znk	콰
znky	콱
znkyy	콲
znkyb	콳
znkl	콴
znklu	콵
znklw	콶
znkc	콷
znks	콸
znksy	콹
znkso	콺
znksa	콻
znksb	콼
znkse	콽
znksx	콾
znksw	콿
znko	쾀
znka	쾁
znkab	쾂
znkb	쾃
znkbb	쾄
znkq	쾅
znku	쾆
znkd	쾇
znkz	쾈
znke	쾉
znkx	쾊
znkw	쾋
znh	쾌
znhy	쾍
znhyy	쾎
znhyb	쾏
znhl	쾐
znhlu	쾑
znhlw	쾒
znhc	쾓
znhs	쾔
znhsy	쾕
znhso	쾖
znhsa	쾗
znhsb	쾘
znhse	쾙
znhsx	쾚
znhsw	쾛
znho	쾜
znha	쾝
znhab	쾞
znhb	쾟
znhbb	쾠
znhq	쾡
znhu	쾢
znhd	쾣
znhz	쾤
znhe	쾥
znhx	쾦
znhw	쾧
zni	쾨
zniy	쾩
zniyy	쾪
zniyb	쾫
znil	쾬
znilu	쾭
znilw	쾮
znic	쾯
znis	쾰
znisy	쾱
zniso	쾲
znisa	쾳
znisb	쾴
znise	쾵
znisx	쾶
znisw	쾷
znio	쾸
znia	쾹
zniab	쾺
znib	쾻
znibb	쾼
zniq	쾽
zniu	쾾
znid	쾿
zniz	쿀
znie	쿁
znix	쿂
zniw	쿃
zm	쿄
zmy	쿅
zmyy	쿆
zmyb	쿇
zml	쿈
zmlu	쿉
zmlw	쿊
zmc	쿋
zms	쿌
zmsy	쿍
zmso	쿎
zmsa	쿏
zmsb	쿐
zmse	쿑
zmsx	쿒
zmsw	쿓
zmo	쿔
zma	쿕
zmab	쿖
zmb	쿗
zmbb	쿘
zmq	쿙
zmu	쿚
zmd	쿛
zmz	쿜
zme	쿝
zmx	쿞
zmw	쿟
zt	쿠
zty	쿡
ztyy	쿢
ztyb	쿣
ztl	쿤
ztlu	쿥
ztlw	쿦
ztc	쿧
zts	쿨
ztsy	쿩
ztso	쿪
ztsa	쿫
ztsb	쿬
ztse	쿭
ztsx	쿮
ztsw	쿯
zto	쿰
zta	쿱
ztab	쿲
ztb	쿳
ztbb	쿴
ztq	쿵
ztu	쿶
ztd	쿷
ztz	쿸
zte	쿹
ztx	쿺
ztw	쿻
ztj	쿼
ztjy	쿽
ztjyy	쿾
ztjyb	쿿
#38
ztjl	퀀
ztjlu	퀁
ztjlw	퀂
ztjc	퀃
ztjs	퀄
ztjsy	퀅
ztjso	퀆
ztjsa	퀇
ztjsb	퀈
ztjse	퀉
ztjsx	퀊
ztjsw	퀋
ztjo	퀌
ztja	퀍
ztjab	퀎
ztjb	퀏
ztjbb	퀐
ztjq	퀑
ztju	퀒
ztjd	퀓
ztjz	퀔
ztje	퀕
ztjx	퀖
ztjw	퀗
ztp	퀘
ztpy	퀙
ztpyy	퀚
ztpyb	퀛
ztpl	퀜
ztplu	퀝
ztplw	퀞
ztpc	퀟
ztps	퀠
ztpsy	퀡
ztpso	퀢
ztpsa	퀣
ztpsb	퀤
ztpse	퀥
ztpsx	퀦
ztpsw	퀧
ztpo	퀨
ztpa	퀩
ztpab	퀪
ztpb	퀫
ztpbb	퀬
ztpq	퀭
ztpu	퀮
ztpd	퀯
ztpz	퀰
ztpe	퀱
ztpx	퀲
ztpw	퀳
zti	퀴
ztiy	퀵
ztiyy	퀶
ztiyb	퀷
ztil	퀸
ztilu	퀹
ztilw	퀺
ztic	퀻
ztis	퀼
ztisy	퀽
ztiso	퀾
ztisa	퀿
ztisb	큀
ztise	큁
ztisx	큂
ztisw	큃
ztio	큄
ztia	큅
ztiab	큆
ztib	큇
ztibb	큈
ztiq	큉
ztiu	큊
ztid	큋
ztiz	큌
ztie	큍
ztix	큎
ztiw	큏
zr	큐
zry	큑
zryy	큒
zryb	큓
zrl	큔
zrlu	큕
zrlw	큖
zrc	큗
zrs	큘
zrsy	큙
zrso	큚
zrsa	큛
zrsb	큜
zrse	큝
zrsx	큞
zrsw	큟
zro	큠
zra	큡
zrab	큢
zrb	큣
zrbb	큤
zrq	큥
zru	큦
zrd	큧
zrz	큨
zre	큩
zrx	큪
zrw	큫
zv	크
zvy	큭
zvyy	큮
zvyb	큯
zvl	큰
zvlu	큱
zvlw	큲
zvc	큳
zvs	클
zvsy	큵
zvso	큶
zvsa	큷
zvsb	큸
zvse	큹
zvsx	큺
zvsw	큻
zvo	큼
zva	큽
zvab	큾
zvb	큿
zvbb	킀
zvq	킁
zvu	킂
zvd	킃
zvz	킄
zve	킅
zvx	킆
zvw	킇
zvi	킈
zviy	킉
zviyy	킊
zviyb	킋
zvil	킌
zvilu	킍
zvilw	킎
zvic	킏
zvis	킐
zvisy	킑
zviso	킒
zvisa	킓
zvisb	킔
zvise	킕
zvisx	킖
zvisw	킗
zvio	킘
zvia	킙
zviab	킚
zvib	킛
zvibb	킜
zviq	킝
zviu	킞
zvid	킟
zviz	킠
zvie	킡
zvix	킢
zviw	킣
zi	키
ziy	킥
ziyy	킦
ziyb	킧
zil	킨
zilu	킩
zilw	킪
zic	킫
zis	킬
zisy	킭
ziso	킮
zisa	킯
zisb	킰
zise	킱
zisx	킲
zisw	킳
zio	킴
zia	킵
ziab	킶
zib	킷
zibb	킸
ziq	킹
ziu	킺
zid	킻
ziz	킼
zie	킽
zix	킾
ziw	킿
ek	타
eky	탁
ekyy	탂
ekyb	탃
ekl	탄
eklu	탅
eklw	탆
ekc	탇
eks	탈
eksy	탉
ekso	탊
eksa	탋
eksb	탌
ekse	탍
eksx	탎
eksw	탏
eko	탐
eka	탑
ekab	탒
ekb	탓
ekbb	탔
ekq	탕
eku	탖
ekd	탗
ekz	탘
eke	탙
ekx	탚
ekw	탛
eh	태
ehy	택
ehyy	탞
ehyb	탟
ehl	탠
ehlu	탡
ehlw	탢
ehc	탣
ehs	탤
ehsy	탥
ehso	탦
ehsa	탧
ehsb	탨
ehse	탩
ehsx	탪
ehsw	탫
eho	탬
eha	탭
ehab	탮
ehb	탯
ehbb	탰
ehq	탱
ehu	탲
ehd	탳
ehz	탴
ehe	탵
ehx	탶
ehw	탷
ef	탸
efy	탹
efyy	탺
efyb	탻
efl	탼
eflu	탽
eflw	탾
efc	탿
#39
efs	턀
efsy	턁
efso	턂
efsa	턃
efsb	턄
efse	턅
efsx	턆
efsw	턇
efo	턈
efa	턉
efab	턊
efb	턋
efbb	턌
efq	턍
efu	턎
efd	턏
efz	턐
efe	턑
efx	턒
efw	턓
ehh	턔
ehhy	턕
ehhyy	턖
ehhyb	턗
ehhl	턘
ehhlu	턙
ehhlw	턚
ehhc	턛
ehhs	턜
ehhsy	턝
ehhso	턞
ehhsa	턟
ehhsb	턠
ehhse	턡
ehhsx	턢
ehhsw	턣
ehho	턤
ehha	턥
ehhab	턦
ehhb	턧
ehhbb	턨
ehhq	턩
ehhu	턪
ehhd	턫
ehhz	턬
ehhe	턭
ehhx	턮
ehhw	턯
ej	터
ejy	턱
ejyy	턲
ejyb	턳
ejl	턴
ejlu	턵
ejlw	턶
ejc	턷
ejs	털
ejsy	턹
ejso	턺
ejsa	턻
ejsb	턼
ejse	턽
ejsx	턾
ejsw	턿
ejo	텀
eja	텁
ejab	텂
ejb	텃
ejbb	텄
ejq	텅
eju	텆
ejd	텇
ejz	텈
eje	텉
ejx	텊
ejw	텋
ep	테
epy	텍
epyy	텎
epyb	텏
epl	텐
eplu	텑
eplw	텒
epc	텓
eps	텔
epsy	텕
epso	텖
epsa	텗
epsb	텘
epse	텙
epsx	텚
epsw	텛
epo	템
epa	텝
epab	텞
epb	텟
epbb	텠
epq	텡
epu	텢
epd	텣
epz	텤
epe	텥
epx	텦
epw	텧
eg	텨
egy	텩
egyy	텪
egyb	텫
egl	텬
eglu	텭
eglw	텮
egc	텯
egs	텰
egsy	텱
egso	텲
egsa	텳
egsb	텴
egse	텵
egsx	텶
egsw	텷
ego	텸
ega	텹
egab	텺
egb	텻
egbb	텼
egq	텽
egu	텾
egd	텿
egz	톀
ege	톁
egx	톂
egw	톃
epp	톄
eppy	톅
eppyy	톆
eppyb	톇
eppl	톈
epplu	톉
epplw	톊
eppc	톋
epps	톌
eppsy	톍
eppso	톎
eppsa	톏
eppsb	톐
eppse	톑
eppsx	톒
eppsw	톓
eppo	톔
eppa	톕
eppab	톖
eppb	톗
eppbb	톘
eppq	톙
eppu	톚
eppd	톛
eppz	톜
eppe	톝
eppx	톞
eppw	톟
en	토
eny	톡
enyy	톢
enyb	톣
enl	톤
enlu	톥
enlw	톦
enc	톧
ens	톨
ensy	톩
enso	톪
ensa	톫
ensb	톬
ense	톭
ensx	톮
ensw	톯
eno	톰
ena	톱
enab	톲
enb	톳
enbb	톴
enq	통
enu	톶
end	톷
enz	톸
ene	톹
enx	톺
enw	톻
enk	톼
enky	톽
enkyy	톾
enkyb	톿
enkl	퇀
enklu	퇁
enklw	퇂
enkc	퇃
enks	퇄
enksy	퇅
enkso	퇆
enksa	퇇
enksb	퇈
enkse	퇉
enksx	퇊
enksw	퇋
enko	퇌
enka	퇍
enkab	퇎
enkb	퇏
enkbb	퇐
enkq	퇑
enku	퇒
enkd	퇓
enkz	퇔
enke	퇕
enkx	퇖
enkw	퇗
enh	퇘
enhy	퇙
enhyy	퇚
enhyb	퇛
enhl	퇜
enhlu	퇝
enhlw	퇞
enhc	퇟
enhs	퇠
enhsy	퇡
enhso	퇢
enhsa	퇣
enhsb	퇤
enhse	퇥
enhsx	퇦
enhsw	퇧
enho	퇨
enha	퇩
enhab	퇪
enhb	퇫
enhbb	퇬
enhq	퇭
enhu	퇮
enhd	퇯
enhz	퇰
enhe	퇱
enhx	퇲
enhw	퇳
eni	퇴
eniy	퇵
eniyy	퇶
eniyb	퇷
enil	퇸
enilu	퇹
enilw	퇺
enic	퇻
enis	퇼
enisy	퇽
eniso	퇾
enisa	퇿
#40
enisb	툀
enise	툁
enisx	툂
enisw	툃
enio	툄
enia	툅
eniab	툆
enib	툇
enibb	툈
eniq	툉
eniu	툊
enid	툋
eniz	툌
enie	툍
enix	툎
eniw	툏
em	툐
emy	툑
emyy	툒
emyb	툓
eml	툔
emlu	툕
emlw	툖
emc	툗
ems	툘
emsy	툙
emso	툚
emsa	툛
emsb	툜
emse	툝
emsx	툞
emsw	툟
emo	툠
ema	툡
emab	툢
emb	툣
embb	툤
emq	툥
emu	툦
emd	툧
emz	툨
eme	툩
emx	툪
emw	툫
et	투
ety	툭
etyy	툮
etyb	툯
etl	툰
etlu	툱
etlw	툲
etc	툳
ets	툴
etsy	툵
etso	툶
etsa	툷
etsb	툸
etse	툹
etsx	툺
etsw	툻
eto	툼
eta	툽
etab	툾
etb	툿
etbb	퉀
etq	퉁
etu	퉂
etd	퉃
etz	퉄
ete	퉅
etx	퉆
etw	퉇
etj	퉈
etjy	퉉
etjyy	퉊
etjyb	퉋
etjl	퉌
etjlu	퉍
etjlw	퉎
etjc	퉏
etjs	퉐
etjsy	퉑
etjso	퉒
etjsa	퉓
etjsb	퉔
etjse	퉕
etjsx	퉖
etjsw	퉗
etjo	퉘
etja	퉙
etjab	퉚
etjb	퉛
etjbb	퉜
etjq	퉝
etju	퉞
etjd	퉟
etjz	퉠
etje	퉡
etjx	퉢
etjw	퉣
etp	퉤
etpy	퉥
etpyy	퉦
etpyb	퉧
etpl	퉨
etplu	퉩
etplw	퉪
etpc	퉫
etps	퉬
etpsy	퉭
etpso	퉮
etpsa	퉯
etpsb	퉰
etpse	퉱
etpsx	퉲
etpsw	퉳
etpo	퉴
etpa	퉵
etpab	퉶
etpb	퉷
etpbb	퉸
etpq	퉹
etpu	퉺
etpd	퉻
etpz	퉼
etpe	퉽
etpx	퉾
etpw	퉿
eti	튀
etiy	튁
etiyy	튂
etiyb	튃
etil	튄
etilu	튅
etilw	튆
etic	튇
etis	튈
etisy	튉
etiso	튊
etisa	튋
etisb	튌
etise	튍
etisx	튎
etisw	튏
etio	튐
etia	튑
etiab	튒
etib	튓
etibb	튔
etiq	튕
etiu	튖
etid	튗
etiz	튘
etie	튙
etix	튚
etiw	튛
er	튜
ery	튝
eryy	튞
eryb	튟
erl	튠
erlu	튡
erlw	튢
erc	튣
ers	튤
ersy	튥
erso	튦
ersa	튧
ersb	튨
erse	튩
ersx	튪
ersw	튫
ero	튬
era	튭
erab	튮
erb	튯
erbb	튰
erq	튱
eru	튲
erd	튳
erz	튴
ere	튵
erx	튶
erw	튷
ev	트
evy	특
evyy	튺
evyb	튻
evl	튼
evlu	튽
evlw	튾
evc	튿
evs	틀
evsy	틁
evso	틂
evsa	틃
evsb	틄
evse	틅
evsx	틆
evsw	틇
evo	틈
eva	틉
evab	틊
evb	틋
evbb	틌
evq	틍
evu	틎
evd	틏
evz	틐
eve	틑
evx	틒
evw	틓
evi	틔
eviy	틕
eviyy	틖
eviyb	틗
evil	틘
evilu	틙
evilw	틚
evic	틛
evis	틜
evisy	틝
eviso	틞
evisa	틟
evisb	틠
evise	틡
evisx	틢
evisw	틣
evio	틤
evia	틥
eviab	틦
evib	틧
evibb	틨
eviq	틩
eviu	틪
evid	틫
eviz	틬
evie	틭
evix	틮
eviw	틯
ei	티
eiy	틱
eiyy	틲
eiyb	틳
eil	틴
eilu	틵
eilw	틶
eic	틷
eis	틸
eisy	틹
eiso	틺
eisa	틻
eisb	틼
eise	틽
eisx	틾
eisw	틿
#41
eio	팀
eia	팁
eiab	팂
eib	팃
eibb	팄
eiq	팅
eiu	팆
eid	팇
eiz	팈
eie	팉
eix	팊
eiw	팋
xk	파
xky	팍
xkyy	팎
xkyb	팏
xkl	판
xklu	팑
xklw	팒
xkc	팓
xks	팔
xksy	팕
xkso	팖
xksa	팗
xksb	팘
xkse	팙
xksx	팚
xksw	팛
xko	팜
xka	팝
xkab	팞
xkb	팟
xkbb	팠
xkq	팡
xku	팢
xkd	팣
xkz	팤
xke	팥
xkx	팦
xkw	팧
xh	패
xhy	팩
xhyy	팪
xhyb	팫
xhl	팬
xhlu	팭
xhlw	팮
xhc	팯
xhs	팰
xhsy	팱
xhso	팲
xhsa	팳
xhsb	팴
xhse	팵
xhsx	팶
xhsw	팷
xho	팸
xha	팹
xhab	팺
xhb	팻
xhbb	팼
xhq	팽
xhu	팾
xhd	팿
xhz	퍀
xhe	퍁
xhx	퍂
xhw	퍃
xf	퍄
xfy	퍅
xfyy	퍆
xfyb	퍇
xfl	퍈
xflu	퍉
xflw	퍊
xfc	퍋
xfs	퍌
xfsy	퍍
xfso	퍎
xfsa	퍏
xfsb	퍐
xfse	퍑
xfsx	퍒
xfsw	퍓
xfo	퍔
xfa	퍕
xfab	퍖
xfb	퍗
xfbb	퍘
xfq	퍙
xfu	퍚
xfd	퍛
xfz	퍜
xfe	퍝
xfx	퍞
xfw	퍟
xhh	퍠
xhhy	퍡
xhhyy	퍢
xhhyb	퍣
xhhl	퍤
xhhlu	퍥
xhhlw	퍦
xhhc	퍧
xhhs	퍨
xhhsy	퍩
xhhso	퍪
xhhsa	퍫
xhhsb	퍬
xhhse	퍭
xhhsx	퍮
xhhsw	퍯
xhho	퍰
xhha	퍱
xhhab	퍲
xhhb	퍳
xhhbb	퍴
xhhq	퍵
xhhu	퍶
xhhd	퍷
xhhz	퍸
xhhe	퍹
xhhx	퍺
xhhw	퍻
xj	퍼
xjy	퍽
xjyy	퍾
xjyb	퍿
xjl	펀
xjlu	펁
xjlw	펂
xjc	펃
xjs	펄
xjsy	펅
xjso	펆
xjsa	펇
xjsb	펈
xjse	펉
xjsx	펊
xjsw	펋
xjo	펌
xja	펍
xjab	펎
xjb	펏
xjbb	펐
xjq	펑
xju	펒
xjd	펓
xjz	펔
xje	펕
xjx	펖
xjw	펗
xp	페
xpy	펙
xpyy	펚
xpyb	펛
xpl	펜
xplu	펝
xplw	펞
xpc	펟
xps	펠
xpsy	펡
xpso	펢
xpsa	펣
xpsb	펤
xpse	펥
xpsx	펦
xpsw	펧
xpo	펨
xpa	펩
xpab	펪
xpb	펫
xpbb	펬
xpq	펭
xpu	펮
xpd	펯
xpz	펰
xpe	펱
xpx	펲
xpw	펳
xg	펴
xgy	펵
xgyy	펶
xgyb	펷
xgl	편
xglu	펹
xglw	펺
xgc	펻
xgs	펼
xgsy	펽
xgso	펾
xgsa	펿
xgsb	폀
xgse	폁
xgsx	폂
xgsw	폃
xgo	폄
xga	폅
xgab	폆
xgb	폇
xgbb	폈
xgq	평
xgu	폊
xgd	폋
xgz	폌
xge	폍
xgx	폎
xgw	폏
xpp	폐
xppy	폑
xppyy	폒
xppyb	폓
xppl	폔
xpplu	폕
xpplw	폖
xppc	폗
xpps	폘
xppsy	폙
xppso	폚
xppsa	폛
xppsb	폜
xppse	폝
xppsx	폞
xppsw	폟
xppo	폠
xppa	폡
xppab	폢
xppb	폣
xppbb	폤
xppq	폥
xppu	폦
xppd	폧
xppz	폨
xppe	폩
xppx	폪
xppw	폫
xn	포
xny	폭
xnyy	폮
xnyb	폯
#42
xnl	폰
xnlu	폱
xnlw	폲
xnc	폳
xns	폴
xnsy	폵
xnso	폶
xnsa	폷
xnsb	폸
xnse	폹
xnsx	폺
xnsw	폻
xno	폼
xna	폽
xnab	폾
xnb	폿
xnbb	퐀
xnq	퐁
xnu	퐂
xnd	퐃
xnz	퐄
xne	퐅
xnx	퐆
xnw	퐇
xnk	퐈
xnky	퐉
xnkyy	퐊
xnkyb	퐋
xnkl	퐌
xnklu	퐍
xnklw	퐎
xnkc	퐏
xnks	퐐
xnksy	퐑
xnkso	퐒
xnksa	퐓
xnksb	퐔
xnkse	퐕
xnksx	퐖
xnksw	퐗
xnko	퐘
xnka	퐙
xnkab	퐚
xnkb	퐛
xnkbb	퐜
xnkq	퐝
xnku	퐞
xnkd	퐟
xnkz	퐠
xnke	퐡
xnkx	퐢
xnkw	퐣
xnh	퐤
xnhy	퐥
xnhyy	퐦
xnhyb	퐧
xnhl	퐨
xnhlu	퐩
xnhlw	퐪
xnhc	퐫
xnhs	퐬
xnhsy	퐭
xnhso	퐮
xnhsa	퐯
xnhsb	퐰
xnhse	퐱
xnhsx	퐲
xnhsw	퐳
xnho	퐴
xnha	퐵
xnhab	퐶
xnhb	퐷
xnhbb	퐸
xnhq	퐹
xnhu	퐺
xnhd	퐻
xnhz	퐼
xnhe	퐽
xnhx	퐾
xnhw	퐿
xni	푀
xniy	푁
xniyy	푂
xniyb	푃
xnil	푄
xnilu	푅
xnilw	푆
xnic	푇
xnis	푈
xnisy	푉
xniso	푊
xnisa	푋
xnisb	푌
xnise	푍
xnisx	푎
xnisw	푏
xnio	푐
xnia	푑
xniab	푒
xnib	푓
xnibb	푔
xniq	푕
xniu	푖
xnid	푗
xniz	푘
xnie	푙
xnix	푚
xniw	푛
xm	표
xmy	푝
xmyy	푞
xmyb	푟
xml	푠
xmlu	푡
xmlw	푢
xmc	푣
xms	푤
xmsy	푥
xmso	푦
xmsa	푧
xmsb	푨
xmse	푩
xmsx	푪
xmsw	푫
xmo	푬
xma	푭
xmab	푮
xmb	푯
xmbb	푰
xmq	푱
xmu	푲
xmd	푳
xmz	푴
xme	푵
xmx	푶
xmw	푷
xt	푸
xty	푹
xtyy	푺
xtyb	푻
xtl	푼
xtlu	푽
xtlw	푾
xtc	푿
xts	풀
xtsy	풁
xtso	풂
xtsa	풃
xtsb	풄
xtse	풅
xtsx	풆
xtsw	풇
xto	품
xta	풉
xtab	풊
xtb	풋
xtbb	풌
xtq	풍
xtu	풎
xtd	풏
xtz	풐
xte	풑
xtx	풒
xtw	풓
xtj	풔
xtjy	풕
xtjyy	풖
xtjyb	풗
xtjl	풘
xtjlu	풙
xtjlw	풚
xtjc	풛
xtjs	풜
xtjsy	풝
xtjso	풞
xtjsa	풟
xtjsb	풠
xtjse	풡
xtjsx	풢
xtjsw	풣
xtjo	풤
xtja	풥
xtjab	풦
xtjb	풧
xtjbb	풨
xtjq	풩
xtju	풪
xtjd	풫
xtjz	풬
xtje	풭
xtjx	풮
xtjw	풯
xtp	풰
xtpy	풱
xtpyy	풲
xtpyb	풳
xtpl	풴
xtplu	풵
xtplw	풶
xtpc	풷
xtps	풸
xtpsy	풹
xtpso	풺
xtpsa	풻
xtpsb	풼
xtpse	풽
xtpsx	풾
xtpsw	풿
xtpo	퓀
xtpa	퓁
xtpab	퓂
xtpb	퓃
xtpbb	퓄
xtpq	퓅
xtpu	퓆
xtpd	퓇
xtpz	퓈
xtpe	퓉
xtpx	퓊
xtpw	퓋
xti	퓌
xtiy	퓍
xtiyy	퓎
xtiyb	퓏
xtil	퓐
xtilu	퓑
xtilw	퓒
xtic	퓓
xtis	퓔
xtisy	퓕
xtiso	퓖
xtisa	퓗
xtisb	퓘
xtise	퓙
xtisx	퓚
xtisw	퓛
xtio	퓜
xtia	퓝
xtiab	퓞
xtib	퓟
#43
xtibb	퓠
xtiq	퓡
xtiu	퓢
xtid	퓣
xtiz	퓤
xtie	퓥
xtix	퓦
xtiw	퓧
xr	퓨
xry	퓩
xryy	퓪
xryb	퓫
xrl	퓬
xrlu	퓭
xrlw	퓮
xrc	퓯
xrs	퓰
xrsy	퓱
xrso	퓲
xrsa	퓳
xrsb	퓴
xrse	퓵
xrsx	퓶
xrsw	퓷
xro	퓸
xra	퓹
xrab	퓺
xrb	퓻
xrbb	퓼
xrq	퓽
xru	퓾
xrd	퓿
xrz	픀
xre	픁
xrx	픂
xrw	픃
xv	프
xvy	픅
xvyy	픆
xvyb	픇
xvl	픈
xvlu	픉
xvlw	픊
xvc	픋
xvs	플
xvsy	픍
xvso	픎
xvsa	픏
xvsb	픐
xvse	픑
xvsx	픒
xvsw	픓
xvo	픔
xva	픕
xvab	픖
xvb	픗
xvbb	픘
xvq	픙
xvu	픚
xvd	픛
xvz	픜
xve	픝
xvx	픞
xvw	픟
xvi	픠
xviy	픡
xviyy	픢
xviyb	픣
xvil	픤
xvilu	픥
xvilw	픦
xvic	픧
xvis	픨
xvisy	픩
xviso	픪
xvisa	픫
xvisb	픬
xvise	픭
xvisx	픮
xvisw	픯
xvio	픰
xvia	픱
xviab	픲
xvib	픳
xvibb	픴
xviq	픵
xviu	픶
xvid	픷
xviz	픸
xvie	픹
xvix	픺
xviw	픻
xi	피
xiy	픽
xiyy	픾
xiyb	픿
xil	핀
xilu	핁
xilw	핂
xic	핃
xis	필
xisy	핅
xiso	핆
xisa	핇
xisb	핈
xise	핉
xisx	핊
xisw	핋
xio	핌
xia	핍
xiab	핎
xib	핏
xibb	핐
xiq	핑
xiu	핒
xid	핓
xiz	핔
xie	핕
xix	핖
xiw	핗
wk	하
wky	학
wkyy	핚
wkyb	핛
wkl	한
wklu	핝
wklw	핞
wkc	핟
wks	할
wksy	핡
wkso	핢
wksa	핣
wksb	핤
wkse	핥
wksx	핦
wksw	핧
wko	함
wka	합
wkab	핪
wkb	핫
wkbb	핬
wkq	항
wku	핮
wkd	핯
wkz	핰
wke	핱
wkx	핲
wkw	핳
wh	해
why	핵
whyy	핶
whyb	핷
whl	핸
whlu	핹
whlw	핺
whc	핻
whs	핼
whsy	핽
whso	핾
whsa	핿
whsb	햀
whse	햁
whsx	햂
whsw	햃
who	햄
wha	햅
whab	햆
whb	햇
whbb	했
whq	행
whu	햊
whd	햋
whz	햌
whe	햍
whx	햎
whw	햏
wf	햐
wfy	햑
wfyy	햒
wfyb	햓
wfl	햔
wflu	햕
wflw	햖
wfc	햗
wfs	햘
wfsy	햙
wfso	햚
wfsa	햛
wfsb	햜
wfse	햝
wfsx	햞
wfsw	햟
wfo	햠
wfa	햡
wfab	햢
wfb	햣
wfbb	햤
wfq	향
wfu	햦
wfd	햧
wfz	햨
wfe	햩
wfx	햪
wfw	햫
whh	햬
whhy	햭
whhyy	햮
whhyb	햯
whhl	햰
whhlu	햱
whhlw	햲
whhc	햳
whhs	햴
whhsy	햵
whhso	햶
whhsa	햷
whhsb	햸
whhse	햹
whhsx	햺
whhsw	햻
whho	햼
whha	햽
whhab	햾
whhb	햿
whhbb	헀
whhq	헁
whhu	헂
whhd	헃
whhz	헄
whhe	헅
whhx	헆
whhw	헇
wj	허
wjy	헉
wjyy	헊
wjyb	헋
wjl	헌
wjlu	헍
wjlw	헎
wjc	헏
#44
wjs	헐
wjsy	헑
wjso	헒
wjsa	헓
wjsb	헔
wjse	헕
wjsx	헖
wjsw	헗
wjo	험
wja	헙
wjab	헚
wjb	헛
wjbb	헜
wjq	헝
wju	헞
wjd	헟
wjz	헠
wje	헡
wjx	헢
wjw	헣
wp	헤
wpy	헥
wpyy	헦
wpyb	헧
wpl	헨
wplu	헩
wplw	헪
wpc	헫
wps	헬
wpsy	헭
wpso	헮
wpsa	헯
wpsb	헰
wpse	헱
wpsx	헲
wpsw	헳
wpo	헴
wpa	헵
wpab	헶
wpb	헷
wpbb	헸
wpq	헹
wpu	헺
wpd	헻
wpz	헼
wpe	헽
wpx	헾
wpw	헿
wg	혀
wgy	혁
wgyy	혂
wgyb	혃
wgl	현
wglu	혅
wglw	혆
wgc	혇
wgs	혈
wgsy	혉
wgso	혊
wgsa	혋
wgsb	혌
wgse	혍
wgsx	혎
wgsw	혏
wgo	혐
wga	협
wgab	혒
wgb	혓
wgbb	혔
wgq	형
wgu	혖
wgd	혗
wgz	혘
wge	혙
wgx	혚
wgw	혛
wpp	혜
wppy	혝
wppyy	혞
wppyb	혟
wppl	혠
wpplu	혡
wpplw	혢
wppc	혣
wpps	혤
wppsy	혥
wppso	혦
wppsa	혧
wppsb	혨
wppse	혩
wppsx	혪
wppsw	혫
wppo	혬
wppa	혭
wppab	혮
wppb	혯
wppbb	혰
wppq	혱
wppu	혲
wppd	혳
wppz	혴
wppe	혵
wppx	혶
wppw	혷
wn	호
wny	혹
wnyy	혺
wnyb	혻
wnl	혼
wnlu	혽
wnlw	혾
wnc	혿
wns	홀
wnsy	홁
wnso	홂
wnsa	홃
wnsb	홄
wnse	홅
wnsx	홆
wnsw	홇
wno	홈
wna	홉
wnab	홊
wnb	홋
wnbb	홌
wnq	홍
wnu	홎
wnd	홏
wnz	홐
wne	홑
wnx	홒
wnw	홓
wnk	화
wnky	확
wnkyy	홖
wnkyb	홗
wnkl	환
wnklu	홙
wnklw	홚
wnkc	홛
wnks	활
wnksy	홝
wnkso	홞
wnksa	홟
wnksb	홠
wnkse	홡
wnksx	홢
wnksw	홣
wnko	홤
wnka	홥
wnkab	홦
wnkb	홧
wnkbb	홨
wnkq	황
wnku	홪
wnkd	홫
wnkz	홬
wnke	홭
wnkx	홮
wnkw	홯
wnh	홰
wnhy	홱
wnhyy	홲
wnhyb	홳
wnhl	홴
wnhlu	홵
wnhlw	홶
wnhc	홷
wnhs	홸
wnhsy	홹
wnhso	홺
wnhsa	홻
wnhsb	홼
wnhse	홽
wnhsx	홾
wnhsw	홿
wnho	횀
wnha	횁
wnhab	횂
wnhb	횃
wnhbb	횄
wnhq	횅
wnhu	횆
wnhd	횇
wnhz	횈
wnhe	횉
wnhx	횊
wnhw	횋
wni	회
wniy	획
wniyy	횎
wniyb	횏
wnil	횐
wnilu	횑
wnilw	횒
wnic	횓
wnis	횔
wnisy	횕
wniso	횖
wnisa	횗
wnisb	횘
wnise	횙
wnisx	횚
wnisw	횛
wnio	횜
wnia	횝
wniab	횞
wnib	횟
wnibb	횠
wniq	횡
wniu	횢
wnid	횣
wniz	횤
wnie	횥
wnix	횦
wniw	횧
wm	효
wmy	횩
wmyy	횪
wmyb	횫
wml	횬
wmlu	횭
wmlw	횮
wmc	횯
wms	횰
wmsy	횱
wmso	횲
wmsa	횳
wmsb	횴
wmse	횵
wmsx	횶
wmsw	횷
wmo	횸
wma	횹
wmab	횺
wmb	횻
wmbb	횼
wmq	횽
wmu	횾
wmd	횿
#45
wmz	훀
wme	훁
wmx	훂
wmw	훃
wt	후
wty	훅
wtyy	훆
wtyb	훇
wtl	훈
wtlu	훉
wtlw	훊
wtc	훋
wts	훌
wtsy	훍
wtso	훎
wtsa	훏
wtsb	훐
wtse	훑
wtsx	훒
wtsw	훓
wto	훔
wta	훕
wtab	훖
wtb	훗
wtbb	훘
wtq	훙
wtu	훚
wtd	훛
wtz	훜
wte	훝
wtx	훞
wtw	훟
wtj	훠
wtjy	훡
wtjyy	훢
wtjyb	훣
wtjl	훤
wtjlu	훥
wtjlw	훦
wtjc	훧
wtjs	훨
wtjsy	훩
wtjso	훪
wtjsa	훫
wtjsb	훬
wtjse	훭
wtjsx	훮
wtjsw	훯
wtjo	훰
wtja	훱
wtjab	훲
wtjb	훳
wtjbb	훴
wtjq	훵
wtju	훶
wtjd	훷
wtjz	훸
wtje	훹
wtjx	훺
wtjw	훻
wtp	훼
wtpy	훽
wtpyy	훾
wtpyb	훿
wtpl	휀
wtplu	휁
wtplw	휂
wtpc	휃
wtps	휄
wtpsy	휅
wtpso	휆
wtpsa	휇
wtpsb	휈
wtpse	휉
wtpsx	휊
wtpsw	휋
wtpo	휌
wtpa	휍
wtpab	휎
wtpb	휏
wtpbb	휐
wtpq	휑
wtpu	휒
wtpd	휓
wtpz	휔
wtpe	휕
wtpx	휖
wtpw	휗
wti	휘
wtiy	휙
wtiyy	휚
wtiyb	휛
wtil	휜
wtilu	휝
wtilw	휞
wtic	휟
wtis	휠
wtisy	휡
wtiso	휢
wtisa	휣
wtisb	휤
wtise	휥
wtisx	휦
wtisw	휧
wtio	휨
wtia	휩
wtiab	휪
wtib	휫
wtibb	휬
wtiq	휭
wtiu	휮
wtid	휯
wtiz	휰
wtie	휱
wtix	휲
wtiw	휳
wr	휴
wry	휵
wryy	휶
wryb	휷
wrl	휸
wrlu	휹
wrlw	휺
wrc	휻
wrs	휼
wrsy	휽
wrso	휾
wrsa	휿
wrsb	흀
wrse	흁
wrsx	흂
wrsw	흃
wro	흄
wra	흅
wrab	흆
wrb	흇
wrbb	흈
wrq	흉
wru	흊
wrd	흋
wrz	흌
wre	흍
wrx	흎
wrw	흏
wv	흐
wvy	흑
wvyy	흒
wvyb	흓
wvl	흔
wvlu	흕
wvlw	흖
wvc	흗
wvs	흘
wvsy	흙
wvso	흚
wvsa	흛
wvsb	흜
wvse	흝
wvsx	흞
wvsw	흟
wvo	흠
wva	흡
wvab	흢
wvb	흣
wvbb	흤
wvq	흥
wvu	흦
wvd	흧
wvz	흨
wve	흩
wvx	흪
wvw	흫
wvi	희
wviy	흭
wviyy	흮
wviyb	흯
wvil	흰
wvilu	흱
wvilw	흲
wvic	흳
wvis	흴
wvisy	흵
wviso	흶
wvisa	흷
wvisb	흸
wvise	흹
wvisx	흺
wvisw	흻
wvio	흼
wvia	흽
wviab	흾
wvib	흿
wvibb	힀
wviq	힁
wviu	힂
wvid	힃
wviz	힄
wvie	힅
wvix	힆
wviw	힇
wi	히
wiy	힉
wiyy	힊
wiyb	힋
wil	힌
wilu	힍
wilw	힎
wic	힏
wis	힐
wisy	힑
wiso	힒
wisa	힓
wisb	힔
wise	힕
wisx	힖
wisw	힗
wio	힘
wia	힙
wiab	힚
wib	힛
wibb	힜
wiq	힝
wiu	힞
wid	힟
wiz	힠
wie	힡
wix	힢
wiw	힣
#諺文正碼結束
######以簡根在後，韓文補碼vr起始######
#	aafv	붞
#	aagv	붢
#	aahv	붮
#	aaiv	붪
#	aajv	붥
#	aamv	붰
#	aanv	붦
#	aapv	붨
#	aarv	붧
#	aatv	붩
#	aavv	붟
#	aakv	붡
#	ahhv	뱂
#	anhv	봆
#	aniv	봂
#	ankv	볹
#	appv	벬
#	ativ	붎
#	atjv	붉
#	atpv	붌
#	aviv	븚
#	bhhv	샚
#	bnhv	솞
#	bniv	솚
#	bnkv	솑
#	bppv	셄
#	btiv	숦
#	btjv	숡
#	btpv	숤
#	bviv	슲
#	chhv	댒
#	cnhv	돖
#	cniv	돒
#	cnkv	돉
#	cppv	덼
#	ctiv	둞
#	ctjv	둙
#	ctpv	둜
#	cviv	듪
#	xhhv	팺
#	xnhv	폾
#	xniv	폺
#	xnkv	폱
#	xppv	펤
#	xtiv	풆
#	xtjv	풁
#	xtpv	풄
#	xviv	픒
#	ehhv	탮
#	enhv	톲
#	eniv	톮
#	enkv	톥
#	eppv	텘
#	etiv	툺
#	etjv	툵
#	etpv	툸
#	eviv	틆
#	zhhv	캢
#	znhv	콦
#	zniv	콢
#	znkv	콙
#	zppv	켌
#	ztiv	쿮
#	ztjv	쿩
#	ztpv	쿬
#	zviv	큺
#	lhhv	냆
#	lnhv	놊
#	lniv	놆
#	lnkv	녽
#	lppv	넰
#	ltiv	눒
#	ltjv	눍
#	ltpv	눐
#	lviv	늞
#	ohhv	맶
#	onhv	몺
#	oniv	몶
#	onkv	몭
#	oppv	멠
#	otiv	뭂
#	otjv	묽
#	otpv	뭀
#	oviv	믎
#	qhhv	앲
#	qnhv	옶
#	qniv	옲
#	qnkv	옩
#	qppv	엜
#	qtiv	욾
#	qtjv	욹
#	qtpv	욼
#	qviv	읊
#	shhv	랪
#	snhv	롮
#	sniv	롪
#	snkv	롡
#	sppv	렔
#	stiv	룶
#	stjv	룱
#	stpv	룴
#	sviv	릂
#	uhhv	잾
#	unhv	좂
#	univ	졾
#	unkv	졵
#	uppv	젨
#	utiv	줊
#	utjv	줅
#	utpv	줈
#	uviv	즖
#	whhv	햆
#	wnhv	홊
#	wniv	홆
#	wnkv	혽
#	wppv	헰
#	wtiv	훒
#	wtjv	훍
#	wtpv	훐
#	wviv	흞
#	dhhv	챖
#	dnhv	촚
#	dniv	촖
#	dnkv	촍
#	dppv	쳀
#	dtiv	춢
#	dtjv	춝
#	dtpv	춠
#	dviv	츮
#	yhhv	갮
#	ynhv	곲
#	yniv	곮
#	ynkv	곥
#	yppv	겘
#	ytiv	굺
#	ytjv	굵
#	ytpv	굸
#	yviv	긆
#######以簡根在後，韓文補碼vr結束######
######與以上相反######
######以基本字根在後，韓文補碼vr起始######
aafv	뺘
aagv	뼈
aahv	빼
aaiv	삐
aajv	뻐
aamv	뾰
aanv	뽀
aapv	뻬
aarv	쀼
aatv	뿌
aavv	쁘
aakv	빠
ahhv	뱨
anhv	봬
aniv	뵈
ankv	봐
appv	볘
ativ	뷔
atjv	붜
atpv	붸
aviv	븨
bhhv	섀
bnhv	쇄
bniv	쇠
bnkv	솨
bppv	셰
btiv	쉬
btjv	숴
btpv	쉐
bviv	싀
chhv	댸
cnhv	돼
cniv	되
cnkv	돠
cppv	뎨
ctiv	뒤
ctjv	둬
ctpv	뒈
cviv	듸
xhhv	퍠
xnhv	퐤
xniv	푀
xnkv	퐈
xppv	폐
xtiv	퓌
xtjv	풔
xtpv	풰
xviv	픠
ehhv	턔
enhv	퇘
eniv	퇴
enkv	톼
eppv	톄
etiv	튀
etjv	퉈
etpv	퉤
eviv	틔
zhhv	컈
znhv	쾌
zniv	쾨
znkv	콰
zppv	켸
ztiv	퀴
ztjv	쿼
ztpv	퀘
zviv	킈
lhhv	냬
lnhv	놰
lniv	뇌
lnkv	놔
lppv	녜
ltiv	뉘
ltjv	눠
ltpv	눼
lviv	늬
ohhv	먜
onhv	뫠
oniv	뫼
onkv	뫄
oppv	몌
otiv	뮈
otjv	뭐
otpv	뭬
oviv	믜
qhhv	얘
qnhv	왜
qniv	외
qnkv	와
qppv	예
qtiv	위
qtjv	워
qtpv	웨
qviv	의
shhv	럐
snhv	뢔
sniv	뢰
snkv	롸
sppv	례
stiv	뤼
stjv	뤄
stpv	뤠
sviv	릐
uhhv	쟤
unhv	좨
univ	죄
unkv	좌
uppv	졔
utiv	쥐
utjv	줘
utpv	줴
uviv	즤
whhv	햬
wnhv	홰
wniv	회
wnkv	화
wppv	혜
wtiv	휘
wtjv	훠
wtpv	훼
wviv	희
dhhv	챼
dnhv	쵀
dniv	최
dnkv	촤
dppv	쳬
dtiv	취
dtjv	춰
dtpv	췌
dviv	츼
yhhv	걔
ynhv	괘
yniv	괴
ynkv	과
yppv	계
ytiv	귀
ytjv	궈
ytpv	궤
yviv	긔
######以基本字根在後，韓文補碼vr結束######
##韓文音節HangulSyllables結束
###韓文漢字對映開始
yk/	耞
yk/	檟
yk/	斝
yk/	宊
yk/	坷
yk/	咖
yk/	傢
yk/	哿
yk/	軻
yk/	跏
yk/	賈
yk/	謌
yk/	訶
yk/	葭
yk/	舸
yk/	笳
yk/	痂
yk/	珈
yk/	柯
yk/	枷
yk/	哥
yk/	呵
yk/	價
yk/	假
yk/	袈
yk/	街
yk/	駕
yk/	迦
yk/	茄
yk/	苛
yk/	稼
yk/	珂
yk/	歌
yk/	架
yk/	暇
yk/	家
yk/	嫁
yk/	嘉
yk/	可
yk/	加
yk/	佳
yk/	伽
yk/	仮
yk/	榎
yky/	珏
yky/	搉
yky/	慤
yky/	覺
yky/	殼
yky/	桷
yky/	擱
yky/	恪
yky/	埆
yky/	咯
yky/	卻
yky/	刻
yky/	脚
yky/	却
yky/	閣
yky/	角
yky/	各
ykl/	迀
ykl/	衎
ykl/	茛
ykl/	秆
ykl/	磵
ykl/	癎
ykl/	玕
ykl/	榦
ykl/	暕
ykl/	偘
ykl/	赶
ykl/	齦
ykl/	諫
ykl/	艱
ykl/	稈
ykl/	桿
ykl/	栞
ykl/	柬
ykl/	杆
ykl/	揀
ykl/	慳
ykl/	奸
ykl/	艮
ykl/	懇
ykl/	墾
ykl/	間
ykl/	肝
ykl/	簡
ykl/	竿
ykl/	看
ykl/	澗
ykl/	幹
ykl/	干
ykl/	姦
ykl/	刊
ykl/	侃
yks/	鶡
yks/	秸
yks/	渴
yks/	楬
yks/	噶
yks/	乫
yks/	鞨
yks/	蠍
yks/	蝎
yks/	羯
yks/	竭
yks/	碣
yks/	曷
yks/	褐
yks/	葛
yks/	喝
yko/	鹼
yko/	鹻
yko/	矙
yko/	澉
yko/	泔
yko/	欿
yko/	憨
yko/	弇
yko/	嵁
yko/	埳
yko/	龕
yko/	鑒
yko/	酣
yko/	邯
yko/	轗
yko/	瞰
yko/	疳
yko/	淦
yko/	歛
yko/	橄
yko/	撼
yko/	戡
yko/	嵌
yko/	坩
yko/	坎
yko/	紺
yko/	減
yko/	鑑
yko/	監
yko/	甘
yko/	柑
yko/	敢
yko/	憾
yko/	感
yko/	堪
yko/	勘
yka/	韐
yka/	鉀
yka/	閘
yka/	胛
yka/	匣
yka/	岬
yka/	甲
ykq/	韁
ykq/	豇
ykq/	茳
ykq/	舡
ykq/	羫
ykq/	羗
ykq/	罡
ykq/	繈
ykq/	穅
ykq/	畺
ykq/	殭
ykq/	忼
ykq/	强
ykq/	壃
ykq/	堈
ykq/	傋
ykq/	鱇
ykq/	襁
ykq/	薑
ykq/	羌
ykq/	絳
ykq/	矼
ykq/	疆
ykq/	杠
ykq/	扛
ykq/	慷
ykq/	崗
ykq/	姜
ykq/	僵
ykq/	剛
ykq/	降
ykq/	鋼
ykq/	講
ykq/	腔
ykq/	綱
ykq/	糠
ykq/	江
ykq/	康
ykq/	彊
ykq/	強
ykq/	橿
ykq/	岡
yh/	闓
yh/	磕
yh/	玠
yh/	槪
yh/	槩
yh/	塏
yh/	匃
yh/	愷
yh/	豈
yh/	盖
yh/	疥
yh/	漑
yh/	揩
yh/	愾
yh/	剴
yh/	价
yh/	個
yh/	鎧
yh/	蓋
yh/	慨
yh/	凱
yh/	開
yh/	芥
yh/	皆
yh/	改
yh/	介
yh/	箇
yhy/	喀
yhy/	客
yhq/	賡
yhq/	硜
yhq/	鏗
yhq/	羹
yhq/	粳
yhq/	更
yhq/	坑
yfy/	醵
yj/	駏
yj/	袪
yj/	蘧
yj/	蕖
yj/	莒
yj/	腒
yj/	胠
yj/	籧
yj/	祛
yj/	昛
yj/	呿
yj/	鉅
yj/	遽
yj/	踞
yj/	苣
yj/	筥
yj/	秬
yj/	炬
yj/	舉
yj/	擧
yj/	據
yj/	倨
yj/	裾
yj/	据
yj/	車
yj/	鋸
yj/	距
yj/	渠
yj/	拒
yj/	巨
yj/	居
yj/	去
yjl/	鞬
yjl/	褰
yjl/	睷
yjl/	犍
yjl/	楗
yjl/	揵
yjl/	騫
yjl/	蹇
yjl/	謇
yjl/	虔
yjl/	腱
yjl/	愆
yjl/	鍵
yjl/	建
yjl/	健
yjl/	件
yjl/	巾
yjl/	乾
yjs/	榤
yjs/	朅
yjs/	乬
yjs/	桀
yjs/	杰
yjs/	乞
yjs/	傑
yjo/	芡
yjo/	撿
yjo/	鈐
yjo/	黔
yjo/	瞼
yjo/	檢
yjo/	劒
yjo/	劍
yjo/	儉
yja/	迲
yja/	刦
yja/	刧
yja/	劫
yja/	怯
yp/	揭
yp/	偈
yp/	憩
ygy/	毄
ygy/	擊
ygy/	鴃
ygy/	鬲
ygy/	骼
ygy/	闃
ygy/	覡
ygy/	膈
ygy/	檄
ygy/	挌
ygy/	激
ygy/	隔
ygy/	格
ygl/	蠲
ygl/	繾
ygl/	縳
ygl/	畎
ygl/	鵑
ygl/	譴
ygl/	羂
ygl/	筧
ygl/	甄
ygl/	狷
ygl/	繭
ygl/	遣
ygl/	見
ygl/	肩
ygl/	絹
ygl/	犬
ygl/	牽
ygl/	堅
ygl/	鰹
ygl/	樫
ygs/	闋
ygs/	觖
ygs/	玦
ygs/	缺
ygs/	抉
ygs/	訣
ygs/	結
ygs/	潔
ygs/	決
ygo/	鼸
ygo/	黚
ygo/	縑
ygo/	岒
ygo/	嗛
ygo/	傔
ygo/	鉗
ygo/	蒹
ygo/	箝
ygo/	歉
ygo/	拑
ygo/	慊
ygo/	謙
ygo/	兼
ygo/	鎌
ygq/	鯁
ygq/	駉
ygq/	顈
ygq/	褧
ygq/	罄
ygq/	綆
ygq/	璥
ygq/	熲
ygq/	焭
ygq/	暻
ygq/	扃
ygq/	憼
ygq/	惸
ygq/	坰
ygq/	儆
ygq/	俓
ygq/	璟
ygq/	炅
ygq/	涇
ygq/	擎
ygq/	倞
ygq/	黥
ygq/	頸
ygq/	竟
ygq/	逕
ygq/	輕
ygq/	謦
ygq/	莖
ygq/	脛
ygq/	耿
ygq/	經
ygq/	絅
ygq/	磬
ygq/	痙
ygq/	畊
ygq/	瓊
ygq/	煢
ygq/	烱
ygq/	檠
ygq/	憬
ygq/	徑
ygq/	哽
ygq/	勍
ygq/	勁
ygq/	剄
ygq/	冏
ygq/	竸
ygq/	頃
ygq/	耕
ygq/	硬
ygq/	梗
ygq/	更
ygq/	庚
ygq/	鯨
ygq/	頚
ygq/	警
ygq/	景
ygq/	敬
ygq/	慶
ygq/	傾
ygq/	驚
ygq/	鏡
ygq/	境
ygq/	卿
ygq/	競
ygq/	京
ypp/	雞
ypp/	葪
ypp/	罽
ypp/	繫
ypp/	縘
ypp/	筓
ypp/	磎
ypp/	瘈
ypp/	烓
ypp/	棨
ypp/	堦
ypp/	鷄
ypp/	髻
ypp/	谿
ypp/	誡
ypp/	薊
ypp/	繼
ypp/	綮
ypp/	禊
ypp/	癸
ypp/	溪
ypp/	悸
ypp/	屆
ypp/	堺
ypp/	計
ypp/	系
ypp/	稽
ypp/	桂
ypp/	契
ypp/	啓
ypp/	係
ypp/	季
ypp/	階
ypp/	界
ypp/	械
ypp/	戒
yq/	雞
yq/	葪
yq/	罽
yq/	繫
yq/	縘
yq/	筓
yq/	磎
yq/	瘈
yq/	烓
yq/	棨
yq/	堦
yq/	鷄
yq/	髻
yq/	谿
yq/	誡
yq/	薊
yq/	繼
yq/	綮
yq/	禊
yq/	癸
yq/	溪
yq/	悸
yq/	屆
yq/	堺
yq/	計
yq/	系
yq/	稽
yq/	桂
yq/	契
yq/	啓
yq/	係
yq/	季
yq/	階
yq/	界
yq/	械
yq/	戒
yn/	鷱
yn/	酤
yn/	郜
yn/	苽
yn/	翺
yn/	羖
yn/	糕
yn/	篙
yn/	稁
yn/	盬
yn/	牯
yn/	櫜
yn/	槀
yn/	暠
yn/	鴣
yn/	靠
yn/	錮
yn/	辜
yn/	賈
yn/	誥
yn/	詁
yn/	觚
yn/	蠱
yn/	胯
yn/	羔
yn/	罟
yn/	箍
yn/	瞽
yn/	睾
yn/	皋
yn/	痼
yn/	沽
yn/	槹
yn/	槁
yn/	栲
yn/	杲
yn/	敲
yn/	攷
yn/	呱
yn/	刳
yn/	凅
yn/	估
yn/	藁
yn/	塙
yn/	叩
yn/	尻
yn/	皐
yn/	告
yn/	拷
yn/	高
yn/	膏
yn/	考
yn/	稿
yn/	鼓
yn/	顧
yn/	雇
yn/	鈷
yn/	菰
yn/	股
yn/	袴
yn/	枯
yn/	故
yn/	庫
yn/	孤
yn/	姑
yn/	固
yn/	古
yn/	苦
yny/	觳
yny/	縠
yny/	嚳
yny/	轂
yny/	槲
yny/	梏
yny/	斛
yny/	哭
yny/	谷
yny/	鵠
yny/	穀
yny/	曲
ynl/	齫
ynl/	鵾
ynl/	髡
ynl/	閫
ynl/	錕
ynl/	裍
ynl/	衮
ynl/	緄
ynl/	琨
ynl/	捆
ynl/	崐
ynl/	堃
ynl/	鶤
ynl/	鯤
ynl/	褌
ynl/	袞
ynl/	滾
ynl/	棍
ynl/	悃
ynl/	崑
ynl/	梱
ynl/	昆
ynl/	坤
ynl/	困
yns/	矻
yns/	搰
yns/	鶻
yns/	汨
yns/	榾
yns/	骨
yns/	滑
ynq/	龔
ynq/	贛
ynq/	珙
ynq/	栱
ynq/	悾
ynq/	崆
ynq/	釭
ynq/	鞏
ynq/	跫
ynq/	蛬
ynq/	蛩
ynq/	蚣
ynq/	箜
ynq/	槓
ynq/	拱
ynq/	倥
ynq/	貢
ynq/	攻
ynq/	控
ynq/	工
ynq/	孔
ynq/	功
ynq/	公
ynq/	空
ynq/	恭
ynq/	恐
ynq/	共
ynq/	供
ynu/	串
ynk/	騍
ynk/	銙
ynk/	窠
ynk/	稞
ynk/	猓
ynk/	撾
ynk/	侉
ynk/	顆
ynk/	踝
ynk/	裹
ynk/	蝌
ynk/	戈
ynk/	夸
ynk/	夥
ynk/	堝
ynk/	鍋
ynk/	跨
ynk/	誇
ynk/	過
ynk/	課
ynk/	菓
ynk/	果
ynk/	科
ynk/	寡
ynk/	瓜
ye/	騍
ye/	銙
ye/	窠
ye/	稞
ye/	猓
ye/	撾
ye/	侉
ye/	顆
ye/	踝
ye/	裹
ye/	蝌
ye/	戈
ye/	夸
ye/	夥
ye/	堝
ye/	鍋
ye/	跨
ye/	誇
ye/	過
ye/	課
ye/	菓
ye/	果
ye/	科
ye/	寡
ye/	瓜
ynky/	鞹
ynky/	躩
ynky/	藿
ynky/	霍
ynky/	癨
ynky/	槨
ynky/	椁
ynky/	郭
ynky/	廓
yey/	鞹
yey/	躩
yey/	藿
yey/	霍
yey/	癨
yey/	槨
yey/	椁
yey/	郭
yey/	廓
ynkl/	髖
ynkl/	雚
ynkl/	錧
ynkl/	輨
ynkl/	筦
ynkl/	窾
ynkl/	祼
ynkl/	瓘
ynkl/	琯
ynkl/	爟
ynkl/	涫
ynkl/	寬
ynkl/	鸛
ynkl/	顴
ynkl/	關
ynkl/	鑵
ynkl/	觀
ynkl/	罐
ynkl/	綰
ynkl/	盥
ynkl/	灌
ynkl/	丱
ynkl/	菅
ynkl/	串
ynkl/	館
ynkl/	貫
ynkl/	管
ynkl/	款
ynkl/	棺
ynkl/	慣
ynkl/	官
ynkl/	冠
yel/	髖
yel/	雚
yel/	錧
yel/	輨
yel/	筦
yel/	窾
yel/	祼
yel/	瓘
yel/	琯
yel/	爟
yel/	涫
yel/	寬
yel/	鸛
yel/	顴
yel/	關
yel/	鑵
yel/	觀
yel/	罐
yel/	綰
yel/	盥
yel/	灌
yel/	丱
yel/	菅
yel/	串
yel/	館
yel/	貫
yel/	管
yel/	款
yel/	棺
yel/	慣
yel/	官
yel/	冠
ynks/	鴰
ynks/	髺
ynks/	适
ynks/	栝
ynks/	佸
ynks/	恝
ynks/	聒
ynks/	刮
ynks/	筈
ynks/	括
yes/	鴰
yes/	髺
yes/	适
yes/	栝
yes/	佸
yes/	恝
yes/	聒
yes/	刮
yes/	筈
yes/	括
ynkq/	誆
ynkq/	茪
ynkq/	磺
ynkq/	爌
ynkq/	炚
ynkq/	恇
ynkq/	珖
ynkq/	獷
ynkq/	桄
ynkq/	侊
ynkq/	纊
ynkq/	鑛
ynkq/	誑
ynkq/	胱
ynkq/	絖
ynkq/	筐
ynkq/	洸
ynkq/	框
ynkq/	曠
ynkq/	廣
ynkq/	壙
ynkq/	光
ynkq/	狂
ynkq/	匡
yeq/	誆
yeq/	茪
yeq/	磺
yeq/	爌
yeq/	炚
yeq/	恇
yeq/	珖
yeq/	獷
yeq/	桄
yeq/	侊
yeq/	纊
yeq/	鑛
yeq/	誑
yeq/	胱
yeq/	絖
yeq/	筐
yeq/	洸
yeq/	框
yeq/	曠
yeq/	廣
yeq/	壙
yeq/	光
yeq/	狂
yeq/	匡
ynh/	詿
ynh/	罣
ynh/	挂
ynh/	咼
ynh/	罫
ynh/	卦
ynh/	掛
ys/	詿
ys/	罣
ys/	挂
ys/	咼
ys/	罫
ys/	卦
ys/	掛
yni/	襘
yni/	蒯
yni/	璝
yni/	廥
yni/	媿
yni/	瑰
yni/	槐
yni/	愧
yni/	恠
yni/	壞
yni/	傀
yni/	乖
yni/	魁
yni/	拐
yni/	怪
yni/	塊
yx/	襘
yx/	蒯
yx/	璝
yx/	廥
yx/	媿
yx/	瑰
yx/	槐
yx/	愧
yx/	恠
yx/	壞
yx/	傀
yx/	乖
yx/	魁
yx/	拐
yx/	怪
yx/	塊
yniy/	虢
yniy/	馘
yxy/	虢
yxy/	馘
yniq/	閎
yniq/	訇
yniq/	觥
yniq/	浤
yniq/	轟
yniq/	肱
yniq/	紘
yniq/	宏
yxq/	閎
yxq/	訇
yxq/	觥
yxq/	浤
yxq/	轟
yxq/	肱
yxq/	紘
yxq/	宏
ym/	齩
ym/	骹
ym/	蹻
ym/	趫
ym/	榷
ym/	暞
ym/	晈
ym/	撟
ym/	憍
ym/	嶠
ym/	姣
ym/	嚙
ym/	噭
ym/	嘐
ym/	嘄
ym/	鉸
ym/	敎
ym/	鵁
ym/	驕
ym/	餃
ym/	轎
ym/	蛟
ym/	膠
ym/	翹
ym/	窖
ym/	磽
ym/	皎
ym/	狡
ym/	攪
ym/	嬌
ym/	咬
ym/	鮫
ym/	郊
ym/	絞
ym/	校
ym/	巧
ym/	佼
ym/	交
ym/	蕎
ym/	矯
ym/	橋
ym/	教
ym/	喬
ym/	僑
ym/	較
yt/	鸜
yt/	鷗
yt/	鷇
yt/	韝
yt/	銶
yt/	軀
yt/	胊
yt/	耉
yt/	絿
yt/	糗
yt/	窛
yt/	癯
yt/	痀
yt/	璆
yt/	漚
yt/	昫
yt/	摳
yt/	捄
yt/	戵
yt/	彀
yt/	岣
yt/	屨
yt/	姤
yt/	坸
yt/	坵
yt/	叴
yt/	厹
yt/	匶
yt/	俱
yt/	俅
yt/	佉
yt/	榘
yt/	龜
yt/	鬮
yt/	驅
yt/	颶
yt/	韭
yt/	鉤
yt/	邱
yt/	遘
yt/	逑
yt/	謳
yt/	詬
yt/	覯
yt/	裘
yt/	衢
yt/	蚯
yt/	蒟
yt/	苟
yt/	舊
yt/	舅
yt/	篝
yt/	窶
yt/	瞿
yt/	疚
yt/	甌
yt/	毬
yt/	毆
yt/	歐
yt/	枸
yt/	柩
yt/	搆
yt/	扣
yt/	懼
yt/	廐
yt/	嶇
yt/	寇
yt/	嫗
yt/	媾
yt/	嘔
yt/	咎
yt/	區
yt/	劬
yt/	冓
yt/	傴
yt/	佝
yt/	釦
yt/	鳩
yt/	韮
yt/	購
yt/	溝
yt/	構
yt/	拘
yt/	垢
yt/	口
yt/	勾
yt/	具
yt/	駒
yt/	駈
yt/	矩
yt/	玖
yt/	狗
yt/	句
yt/	九
yt/	究
yt/	球
yt/	灸
yt/	求
yt/	救
yt/	仇
yt/	久
yt/	丘
yt/	臼
yty/	麴
yty/	麯
yty/	匊
yty/	跼
yty/	鞫
yty/	國
yty/	局
yty/	鞠
yty/	菊
yty/	掬
ytl/	珺
ytl/	捃
ytl/	裙
ytl/	羣
ytl/	窘
ytl/	皸
ytl/	桾
ytl/	郡
ytl/	軍
ytl/	群
ytl/	君
yts/	詘
yts/	淈
yts/	崛
yts/	倔
yts/	堀
yts/	窟
yts/	掘
yts/	屈
ytq/	躳
ytq/	芎
ytq/	躬
ytq/	穹
ytq/	窮
ytq/	弓
ytq/	宮
ytjl/	睠
ytjl/	淃
ytjl/	棬
ytjl/	勌
ytjl/	蜷
ytjl/	綣
ytjl/	眷
ytjl/	權
ytjl/	惓
ytjl/	圈
ytjl/	卷
ytjl/	勸
ytjl/	捲
ytjl/	拳
ytjl/	券
ytjl/	倦
yal/	睠
yal/	淃
yal/	棬
yal/	勌
yal/	蜷
yal/	綣
yal/	眷
yal/	權
yal/	惓
yal/	圈
yal/	卷
yal/	勸
yal/	捲
yal/	拳
yal/	券
yal/	倦
ytjs/	闕
ytjs/	蹶
ytjs/	獗
ytjs/	厥
ytjs/	蕨
yas/	闕
yas/	蹶
yas/	獗
yas/	厥
yas/	蕨
ytp/	麂
ytp/	闠
ytp/	繢
ytp/	簋
ytp/	篑
ytp/	樻
ytp/	撅
ytp/	憒
ytp/	劂
ytp/	佹
ytp/	氿
ytp/	饋
ytp/	餽
ytp/	跪
ytp/	詭
ytp/	櫃
ytp/	匱
ytp/	几
ytp/	潰
ytp/	軌
ytp/	机
yz/	麂
yz/	闠
yz/	繢
yz/	簋
yz/	篑
yz/	樻
yz/	撅
yz/	憒
yz/	劂
yz/	佹
yz/	氿
yz/	饋
yz/	餽
yz/	跪
yz/	詭
yz/	櫃
yz/	匱
yz/	几
yz/	潰
yz/	軌
yz/	机
yti/	晷
yti/	龜
yti/	歸
yti/	句
yti/	鬼
yti/	貴
yd/	晷
yd/	龜
yd/	歸
yd/	句
yd/	鬼
yd/	貴
yr/	頍
yr/	闚
yr/	邽
yr/	跬
yr/	虯
yr/	虬
yr/	睽
yr/	潙
yr/	楏
yr/	暌
yr/	巋
yr/	嬀
yr/	嫢
yr/	呌
yr/	刲
yr/	馗
yr/	閨
yr/	逵
yr/	赳
yr/	糺
yr/	竅
yr/	硅
yr/	樛
yr/	揆
yr/	奎
yr/	槻
yr/	珪
yr/	圭
yr/	叫
yr/	糾
yr/	規
yr/	窺
yr/	葵
yrl/	麏
yrl/	筠
yrl/	畇
yrl/	囷
yrl/	勻
yrl/	龜
yrl/	鈞
yrl/	菌
yrl/	均
yrs/	橘
yvy/	郄
yvy/	郤
yvy/	棘
yvy/	屐
yvy/	尅
yvy/	剋
yvy/	亟
yvy/	克
yvy/	隙
yvy/	戟
yvy/	劇
yvy/	極
yvl/	靳
yvl/	觔
yvl/	漌
yvl/	廑
yvl/	巹
yvl/	墐
yvl/	厪
yvl/	卺
yvl/	劤
yvl/	饉
yvl/	釿
yvl/	跟
yvl/	覲
yvl/	菫
yvl/	瑾
yvl/	槿
yvl/	懃
yvl/	根
yvl/	近
yvl/	謹
yvl/	芹
yvl/	筋
yvl/	斤
yvl/	勤
yvl/	僅
yvs/	契
yvo/	黅
yvo/	芩
yvo/	笒
yvo/	昑
yvo/	嶔
yvo/	妗
yvo/	唫
yvo/	衾
yvo/	擒
yvo/	噤
yvo/	今
yvo/	檎
yvo/	金
yvo/	襟
yvo/	衿
yvo/	禽
yvo/	禁
yvo/	琴
yvo/	錦
yva/	芨
yva/	礏
yva/	圾
yva/	伋
yva/	皀
yva/	岌
yva/	給
yva/	級
yva/	笈
yva/	汲
yva/	急
yva/	及
yva/	扱
yvq/	殑
yvq/	矜
yvq/	兢
yvq/	亘
yvq/	亙
yvq/	肯
yi/	黖
yi/	鬐
yi/	頎
yi/	隑
yi/	錤
yi/	覉
yi/	蟣
yi/	蜝
yi/	虁
yi/	蘄
yi/	芰
yi/	芪
yi/	肵
yi/	耭
yi/	綦
yi/	綥
yi/	禨
yi/	璣
yi/	璂
yi/	玘
yi/	猉
yi/	炁
yi/	歧
yi/	暣
yi/	旣
yi/	旂
yi/	攲
yi/	愭
yi/	忮
yi/	庋
yi/	屺
yi/	夔
yi/	墍
yi/	僛
yi/	錡
yi/	琪
yi/	琦
yi/	麒
yi/	驥
yi/	騏
yi/	饑
yi/	跂
yi/	豈
yi/	譏
yi/	覬
yi/	耆
yi/	羇
yi/	羈
yi/	綺
yi/	祺
yi/	畸
yi/	淇
yi/	沂
yi/	氣
yi/	棊
yi/	杞
yi/	朞
yi/	曁
yi/	掎
yi/	弃
yi/	圻
yi/	嗜
yi/	剞
yi/	冀
yi/	箕
yi/	鰭
yi/	肌
yi/	其
yi/	埼
yi/	崎
yi/	碁
yi/	己
yi/	祁
yi/	祇
yi/	欺
yi/	技
yi/	妓
yi/	騎
yi/	飢
yi/	起
yi/	記
yi/	紀
yi/	祈
yi/	畿
yi/	汽
yi/	機
yi/	棄
yi/	棋
yi/	期
yi/	旗
yi/	忌
yi/	幾
yi/	岐
yi/	寄
yi/	奇
yi/	基
yi/	器
yi/	伎
yi/	企
yi/	磯
yil/	緊
yis/	蛣
yis/	姞
yis/	拮
yis/	佶
yis/	桔
yis/	吉
yio/	金
yyiy/	喫
fiy/	喫
lk/	糥
lk/	挪
lk/	挐
lk/	糯
lk/	煖
lk/	梛
lk/	拿
lk/	拏
lk/	懦
lk/	娜
lk/	儺
lk/	那
lk/	奈
lky/	諾
lkl/	餪
lkl/	煗
lkl/	偄
lkl/	赧
lkl/	難
lkl/	暖
lks/	捏
lks/	捺
lko/	湳
lko/	柟
lko/	枏
lko/	娚
lko/	喃
lko/	楠
lko/	南
lko/	男
lka/	衲
lka/	納
lkq/	囊
lkq/	曩
lkq/	娘
lh/	鼐
lh/	柰
lh/	嬭
lh/	奶
lh/	內
lh/	迺
lh/	乃
lh/	匂
lh/	奈
lh/	耐
lg/	女
lgy/	惄
lgl/	秊
lgl/	碾
lgl/	撚
lgl/	年
lgo/	拈
lgo/	恬
lgo/	捻
lgo/	念
lgq/	寗
lgq/	儜
lgq/	濘
lgq/	佞
lgq/	嚀
lgq/	寧
ln/	笯
ln/	猱
ln/	峱
ln/	駑
ln/	臑
ln/	瑙
ln/	弩
ln/	孥
ln/	呶
ln/	怒
ln/	奴
ln/	努
lnq/	醲
lnq/	穠
lnq/	噥
lnq/	儂
lnq/	農
lnq/	膿
lnq/	濃
lni/	餒
lni/	腦
lni/	惱
lx/	餒
lx/	腦
lx/	惱
lm/	裊
lm/	磠
lm/	淖
lm/	鐃
lm/	嬲
lm/	嫋
lm/	尿
lm/	溺
lt/	啂
lt/	耨
ltl/	嫩
lts/	訥
lts/	肭
lts/	吶
lr/	杻
lr/	忸
lr/	紐
lr/	靵
lry/	衄
lvq/	能
li/	柅
li/	呢
li/	你
li/	膩
li/	怩
li/	祢
li/	禰
li/	尼
li/	泥
liy/	匿
liy/	溺
lis/	暱
lis/	昵
ck/	爹
ck/	茶
ck/	多
ckl/	腶
ckl/	耑
ckl/	簞
ckl/	癉
ckl/	漙
ckl/	坍
ckl/	鄲
ckl/	袒
ckl/	蜑
ckl/	緞
ckl/	湍
ckl/	斷
ckl/	慱
ckl/	彖
ckl/	團
ckl/	單
ckl/	亶
ckl/	椴
ckl/	段
ckl/	檀
ckl/	壇
ckl/	鍛
ckl/	蛋
ckl/	胆
ckl/	端
ckl/	短
ckl/	旦
ckl/	担
ckl/	丹
ckl/	但
cks/	澾
cks/	韃
cks/	靼
cks/	闥
cks/	疸
cks/	獺
cks/	撻
cks/	怛
cks/	妲
cks/	達
cko/	黵
cko/	黮
cko/	錟
cko/	郯
cko/	薝
cko/	聃
cko/	禫
cko/	墰
cko/	噉
cko/	儋
cko/	譚
cko/	覃
cko/	蕁
cko/	膽
cko/	罎
cko/	痰
cko/	澹
cko/	潭
cko/	毯
cko/	擔
cko/	憺
cko/	壜
cko/	啗
cko/	啖
cko/	曇
cko/	談
cko/	湛
cko/	淡
cka/	龘
cka/	遝
cka/	畓
cka/	踏
cka/	答
cka/	沓
ckq/	餹
ckq/	餳
ckq/	鏜
ckq/	讜
ckq/	璫
ckq/	瑭
ckq/	檔
ckq/	搪
ckq/	戇
ckq/	倘
ckq/	黨
ckq/	鐺
ckq/	襠
ckq/	蟷
ckq/	螳
ckq/	礑
ckq/	瞠
ckq/	當
ckq/	溏
ckq/	棠
ckq/	幢
ckq/	儻
ckq/	撞
ckq/	堂
ckq/	糖
ckq/	塘
ckq/	唐
ch/	汏
ch/	旲
ch/	懟
ch/	坮
ch/	儓
ch/	鐓
ch/	臺
ch/	玳
ch/	擡
ch/	帶
ch/	對
ch/	垈
ch/	大
ch/	代
ch/	黛
ch/	隊
ch/	貸
ch/	袋
ch/	戴
ch/	待
ch/	岱
ch/	碓
chy/	宅
chy/	德
chy/	悳
cn/	鼗
cn/	鞱
cn/	鞀
cn/	酴
cn/	稌
cn/	禱
cn/	涂
cn/	洮
cn/	搯
cn/	慆
cn/	忉
cn/	弢
cn/	壔
cn/	燾
cn/	饕
cn/	韜
cn/	闍
cn/	蹈
cn/	覩
cn/	稻
cn/	睹
cn/	滔
cn/	濤
cn/	盜
cn/	櫂
cn/	棹
cn/	檮
cn/	擣
cn/	搗
cn/	掉
cn/	掏
cn/	圖
cn/	叨
cn/	道
cn/	萄
cn/	導
cn/	陶
cn/	逃
cn/	到
cn/	淘
cn/	桃
cn/	悼
cn/	嶋
cn/	島
cn/	刀
cn/	倒
cn/	度
cn/	鍍
cn/	都
cn/	途
cn/	賭
cn/	菟
cn/	渡
cn/	徒
cn/	屠
cn/	塗
cn/	堵
cn/	跳
cn/	挑
cny/	瀆
cny/	櫝
cny/	黷
cny/	讀
cny/	纛
cny/	獨
cny/	犢
cny/	牘
cny/	毒
cny/	篤
cny/	禿
cny/	督
cnl/	躉
cnl/	焞
cnl/	潡
cnl/	旽
cnl/	墩
cnl/	弴
cnl/	燉
cnl/	暾
cnl/	頓
cnl/	豚
cnl/	沌
cnl/	敦
cnl/	惇
cns/	堗
cns/	乭
cns/	咄
cns/	突
cnq/	蝀
cnq/	茼
cnq/	涷
cnq/	朣
cnq/	彤
cnq/	峒
cnq/	垌
cnq/	哃
cnq/	侗
cnq/	蕫
cnq/	鮗
cnq/	苳
cnq/	艟
cnq/	疼
cnq/	潼
cnq/	橦
cnq/	僮
cnq/	錬
cnq/	銅
cnq/	胴
cnq/	童
cnq/	瞳
cnq/	洞
cnq/	憧
cnq/	同
cnq/	動
cnq/	働
cnq/	董
cnq/	棟
cnq/	東
cnq/	凍
cnq/	冬
cnq/	桐
cnq/	仝
ct/	陡
ct/	脰
ct/	枓
ct/	斁
ct/	讀
ct/	蠹
ct/	蚪
ct/	荳
ct/	肚
ct/	竇
ct/	抖
ct/	頭
ct/	豆
ct/	痘
ct/	杜
ct/	斗
ct/	逗
ct/	兜
ctl/	迍
ctl/	芚
ctl/	窀
ctl/	遯
ctl/	臀
ctl/	鈍
ctl/	遁
ctl/	屯
cts/	乧
cvy/	得
cvq/	螣
cvq/	墱
cvq/	凳
cvq/	鄧
cvq/	縢
cvq/	籐
cvq/	磴
cvq/	滕
cvq/	橙
cvq/	嶝
cvq/	騰
cvq/	鐙
cvq/	謄
cvq/	藤
cvq/	等
cvq/	燈
cvq/	登
sk/	驘
sk/	臝
sk/	砢
sk/	曪
sk/	囉
sk/	倮
sk/	騾
sk/	鑼
sk/	邏
sk/	蘿
sk/	癩
sk/	瘰
sk/	懶
sk/	喇
sk/	裸
sk/	螺
sk/	羅
sky/	嗠
sky/	駱
sky/	珞
sky/	犖
sky/	烙
sky/	樂
sky/	酪
sky/	落
sky/	絡
sky/	洛
skl/	灓
skl/	攔
skl/	幱
skl/	鸞
skl/	闌
skl/	鑾
skl/	襴
skl/	爛
skl/	瀾
skl/	欒
skl/	嬾
skl/	亂
skl/	蘭
skl/	欄
skl/	卵
sks/	辢
sks/	辣
sks/	埒
sks/	剌
sko/	擥
sko/	惏
sko/	覽
sko/	襤
sko/	纜
sko/	籃
sko/	欖
sko/	攬
sko/	婪
sko/	藍
sko/	濫
sko/	嵐
ska/	蠟
ska/	啦
ska/	鑞
ska/	臘
ska/	拉
skq/	閬
skq/	蜋
skq/	稂
skq/	硠
skq/	郞
skq/	螂
skq/	莨
skq/	瑯
skq/	琅
skq/	郎
skq/	狼
skq/	浪
skq/	榔
skq/	朗
skq/	廊
sh/	騋
sh/	萊
sh/	淶
sh/	崍
sh/	徠
sh/	來
shq/	冷
sfy/	畧
sfy/	略
sfy/	掠
sfq/	樑
sfq/	悢
sfq/	魎
sfq/	輛
sfq/	踉
sfq/	粮
sfq/	粱
sfq/	喨
sfq/	凉
sfq/	兩
sfq/	倆
sfq/	量
sfq/	諒
sfq/	良
sfq/	糧
sfq/	涼
sfq/	梁
sfq/	亮
sfq/	椋
sg/	邌
sg/	戾
sg/	儢
sg/	厲
sg/	黎
sg/	驪
sg/	驢
sg/	閭
sg/	鑢
sg/	蠡
sg/	蠣
sg/	藜
sg/	臚
sg/	膂
sg/	糲
sg/	礪
sg/	癘
sg/	濾
sg/	櫚
sg/	梠
sg/	廬
sg/	唳
sg/	勵
sg/	儷
sg/	呂
sg/	麗
sg/	旅
sg/	慮
sg/	侶
sgy/	酈
sgy/	歷
sgy/	曆
sgy/	攊
sgy/	靂
sgy/	轣
sgy/	轢
sgy/	礫
sgy/	癧
sgy/	瀝
sgy/	櫪
sgy/	櫟
sgy/	力
sgl/	湅
sgl/	孌
sgl/	璉
sgl/	楝
sgl/	攣
sgl/	戀
sgl/	連
sgl/	蓮
sgl/	聯
sgl/	練
sgl/	煉
sgl/	漣
sgl/	憐
sgl/	鍊
sgs/	颲
sgs/	挒
sgs/	洌
sgs/	捩
sgs/	冽
sgs/	裂
sgs/	烈
sgs/	劣
sgs/	列
sgo/	磏
sgo/	殮
sgo/	瀲
sgo/	濂
sgo/	斂
sgo/	奩
sgo/	簾
sgo/	廉
sga/	躐
sga/	鬣
sga/	獵
sgq/	鹷
sgq/	軨
sgq/	翎
sgq/	笭
sgq/	秢
sgq/	泠
sgq/	欞
sgq/	岭
sgq/	姈
sgq/	呤
sgq/	另
sgq/	昤
sgq/	岺
sgq/	齡
sgq/	鴒
sgq/	靈
sgq/	逞
sgq/	蛉
sgq/	聆
sgq/	羚
sgq/	囹
sgq/	零
sgq/	鈴
sgq/	苓
sgq/	玲
sgq/	怜
sgq/	嶺
sgq/	伶
sgq/	令
sgq/	領
spp/	澧
spp/	鱧
spp/	隸
spp/	醴
spp/	禮
spp/	隷
spp/	例
sq/	澧
sq/	鱧
sq/	隸
sq/	醴
sq/	禮
sq/	隷
sq/	例
sn/	鸕
sn/	髗
sn/	鐪
sn/	窂
sn/	玈
sn/	潞
sn/	擄
sn/	壚
sn/	塷
sn/	鹵
sn/	鱸
sn/	顱
sn/	鑪
sn/	轤
sn/	輅
sn/	蘆
sn/	艫
sn/	艪
sn/	盧
sn/	癆
sn/	爐
sn/	瀘
sn/	滷
sn/	撈
sn/	勞
sn/	老
sn/	露
sn/	路
sn/	櫓
sn/	魯
sn/	虜
sn/	鷺
sny/	騄
sny/	錄
sny/	菉
sny/	簏
sny/	淥
sny/	彔
sny/	圥
sny/	綠
sny/	轆
sny/	祿
sny/	碌
sny/	麓
sny/	鹿
sny/	漉
snl/	論
snq/	龎
snq/	礱
snq/	曨
snq/	攏
snq/	儱
snq/	隴
snq/	蘢
snq/	籠
snq/	瓏
snq/	朧
snq/	壟
snq/	聾
snq/	弄
snq/	瀧
sni/	顂
sni/	酹
sni/	纇
sni/	礧
sni/	礌
sni/	攂
sni/	賴
sni/	瀨
sni/	賚
sni/	誄
sni/	蕾
sni/	耒
sni/	罍
sni/	籟
sni/	磊
sni/	儡
sni/	牢
sni/	賂
sni/	雷
sx/	顂
sx/	酹
sx/	纇
sx/	礧
sx/	礌
sx/	攂
sx/	賴
sx/	瀨
sx/	賚
sx/	誄
sx/	蕾
sx/	耒
sx/	罍
sx/	籟
sx/	磊
sx/	儡
sx/	牢
sx/	賂
sx/	雷
sm/	飉
sm/	飂
sm/	膋
sm/	獠
sm/	漻
sm/	嫽
sm/	嘹
sm/	鬧
sm/	鐐
sm/	醪
sm/	蓼
sm/	聊
sm/	繚
sm/	燎
sm/	潦
sm/	暸
sm/	撩
sm/	廖
sm/	遼
sm/	瞭
sm/	療
sm/	料
sm/	寮
sm/	僚
sm/	了
smq/	龒
smq/	龍
st/	蔞
st/	耬
st/	淚
st/	慺
st/	嶁
st/	屢
st/	嘍
st/	髏
st/	陋
st/	鏤
st/	褸
st/	螻
st/	縷
st/	瘻
st/	樓
st/	壘
st/	僂
st/	漏
st/	婁
st/	累
sr/	鶹
sr/	遛
sr/	纍
sr/	橊
sr/	縲
sr/	瘤
sr/	瀏
sr/	榴
sr/	旒
sr/	類
sr/	瑠
sr/	硫
sr/	留
sr/	琉
sr/	溜
sr/	流
sr/	劉
sr/	柳
sr/	謬
sry/	僇
sry/	戮
sry/	勠
sry/	六
sry/	陸
srl/	掄
srl/	綸
srl/	淪
srl/	崙
srl/	侖
srl/	輪
srl/	倫
srs/	溧
srs/	嵂
srs/	慄
srs/	律
srs/	栗
srq/	癃
srq/	窿
srq/	隆
svy/	泐
svy/	勒
svy/	肋
svo/	澟
svo/	凜
svo/	廩
svo/	凛
svq/	倰
svq/	蔆
svq/	楞
svq/	陵
svq/	稜
svq/	凌
svq/	菱
svq/	綾
si/	邐
si/	螭
si/	离
si/	嫠
si/	娌
si/	唎
si/	剺
si/	涖
si/	黐
si/	魑
si/	釐
si/	貍
si/	蜊
si/	莉
si/	莅
si/	羸
si/	籬
si/	犁
si/	漓
si/	罹
si/	悧
si/	俐
si/	俚
si/	厘
si/	離
si/	里
si/	裡
si/	裏
si/	痢
si/	璃
si/	理
si/	梨
si/	李
si/	履
si/	吏
si/	利
si/	哩
si/	狸
si/	鯉
si/	浬
sil/	鏻
sil/	轔
sil/	繗
sil/	粦
sil/	磷
sil/	璘
sil/	獜
sil/	潾
sil/	嶙
sil/	驎
sil/	躪
sil/	躙
sil/	藺
sil/	麟
sil/	鱗
sil/	隣
sil/	燐
sio/	粼
sio/	霖
sio/	鄰
sio/	痳
sio/	悋
sio/	吝
sio/	臨
sio/	琳
sio/	淋
sio/	林
sia/	砬
sia/	岦
sia/	粒
sia/	立
sia/	笠
ok/	麽
ok/	螞
ok/	劘
ok/	蟇
ok/	碼
ok/	痲
ok/	瑪
ok/	麼
ok/	媽
ok/	麿
ok/	麻
ok/	魔
ok/	磨
ok/	摩
ok/	馬
oky/	鏌
oky/	邈
oky/	瞙
oky/	寞
oky/	膜
oky/	幕
oky/	莫
oky/	漠
okl/	鏋
okl/	晚
okl/	嫚
okl/	墁
okl/	鬘
okl/	饅
okl/	鏝
okl/	輓
okl/	蹣
okl/	謾
okl/	蠻
okl/	萬
okl/	縵
okl/	瞞
okl/	灣
okl/	滿
okl/	彎
okl/	幔
okl/	巒
okl/	曼
okl/	卍
okl/	蔓
okl/	漫
okl/	慢
okl/	万
okl/	娩
okl/	晩
okl/	挽
okl/	鰻
oks/	帕
oks/	唜
oks/	靺
oks/	襪
oks/	茉
oks/	秣
oks/	沫
oks/	末
oks/	抹
okq/	邙
okq/	輞
okq/	莾
okq/	漭
okq/	汒
okq/	魍
okq/	蟒
okq/	莽
okq/	茫
okq/	芒
okq/	罔
okq/	惘
okq/	網
okq/	妄
okq/	望
okq/	忙
okq/	忘
okq/	亡
oh/	霉
oh/	酶
oh/	玫
oh/	沬
oh/	每
oh/	怰
oh/	邁
oh/	賣
oh/	莓
oh/	苺
oh/	眛
oh/	寐
oh/	魅
oh/	枚
oh/	昧
oh/	妹
oh/	埋
oh/	呆
oh/	買
oh/	煤
oh/	楳
oh/	梅
oh/	媒
oh/	罵
ohy/	貃
ohy/	麥
ohy/	驀
ohy/	陌
ohy/	貘
ohy/	貊
ohy/	脉
ohy/	脈
ohq/	甿
ohq/	甍
ohq/	氓
ohq/	儚
ohq/	盲
ohq/	猛
ohq/	孟
ohq/	盟
ohq/	萌
ohq/	虻
ogy/	覓
ogy/	幎
ogy/	冪
ogy/	糸
ogl/	麵
ogl/	糆
ogl/	沔
ogl/	麪
ogl/	緜
ogl/	眄
ogl/	湎
ogl/	冕
ogl/	俛
ogl/	面
ogl/	緬
ogl/	綿
ogl/	棉
ogl/	免
ogl/	眠
ogl/	勉
ogs/	衊
ogs/	篾
ogs/	滅
ogs/	蔑
ogq/	蓂
ogq/	洺
ogq/	椧
ogq/	酩
ogq/	螟
ogq/	茗
ogq/	瞑
ogq/	溟
ogq/	暝
ogq/	鳴
ogq/	銘
ogq/	明
ogq/	命
ogq/	名
ogq/	冥
ogq/	皿
opp/	袂
oq/	袂
on/	麰
on/	蟊
on/	蝥
on/	芼
on/	眊
on/	摹
on/	恈
on/	嫫
on/	媢
on/	侔
on/	髦
on/	謨
on/	耄
on/	糢
on/	眸
on/	皃
on/	瑁
on/	旄
on/	姆
on/	耗
on/	毛
on/	模
on/	摸
on/	矛
on/	牟
on/	粍
on/	鉾
on/	貌
on/	謀
on/	冒
on/	某
on/	帽
on/	母
on/	暮
on/	慕
on/	募
on/	侮
on/	茅
on/	牡
on/	姥
ony/	坶
ony/	鶩
ony/	苜
ony/	沐
ony/	凩
ony/	目
ony/	木
ony/	穆
ony/	睦
ony/	牧
ons/	沒
ons/	歿
onq/	鸏
onq/	雺
onq/	瞢
onq/	溕
onq/	懞
onq/	幪
onq/	艨
onq/	矇
onq/	濛
onq/	朦
onq/	曚
onq/	蒙
onq/	夢
om/	貓
om/	竗
om/	淼
om/	藐
om/	眇
om/	渺
om/	昴
om/	杳
om/	妙
om/	墓
om/	錨
om/	苗
om/	描
om/	廟
om/	猫
om/	卯
ot/	騖
ot/	膴
ot/	珷
ot/	儛
ot/	誣
ot/	繆
ot/	毋
ot/	楙
ot/	无
ot/	拇
ot/	懋
ot/	憮
ot/	廡
ot/	巫
ot/	嘸
ot/	茂
ot/	鵡
ot/	霧
ot/	無
ot/	務
ot/	貿
ot/	戊
ot/	蕪
ot/	舞
ot/	武
ot/	撫
ot/	畝
oty/	嘿
oty/	默
oty/	墨
otl/	雯
otl/	璊
otl/	炆
otl/	汶
otl/	抆
otl/	紊
otl/	捫
otl/	懣
otl/	悗
otl/	刎
otl/	們
otl/	匁
otl/	門
otl/	紋
otl/	問
otl/	聞
otl/	文
otl/	吻
otl/	蚊
ots/	沕
ots/	勿
ots/	物
oi/	蘼
oi/	苿
oi/	獼
oi/	湄
oi/	洣
oi/	楣
oi/	敉
oi/	媺
oi/	媄
oi/	娓
oi/	亹
oi/	渼
oi/	黴
oi/	靡
oi/	麋
oi/	薇
oi/	縻
oi/	糜
oi/	瀰
oi/	彌
oi/	弭
oi/	嵋
oi/	媚
oi/	弥
oi/	迷
oi/	未
oi/	味
oi/	米
oi/	美
oi/	眉
oi/	微
oi/	尾
oi/	謎
oi/	梶
oil/	鰵
oil/	閩
oil/	苠
oil/	緍
oil/	玟
oil/	湣
oil/	暋
oil/	旼
oil/	敃
oil/	慜
oil/	忟
oil/	珉
oil/	忞
oil/	黽
oil/	閔
oil/	罠
oil/	緡
oil/	泯
oil/	旻
oil/	憫
oil/	愍
oil/	岷
oil/	悶
oil/	民
oil/	敏
ois/	滵
ois/	謐
ois/	樒
ois/	蜜
ois/	密
aky/	髆
aky/	鎛
aky/	牔
aky/	欂
aky/	剝
aky/	駮
aky/	雹
aky/	膊
aky/	璞
aky/	珀
aky/	樸
aky/	搏
aky/	亳
aky/	朴
aky/	撲
aky/	駁
aky/	縛
aky/	迫
aky/	薄
aky/	舶
aky/	粕
aky/	箔
aky/	泊
aky/	拍
aky/	博
akl/	頖
akl/	螌
akl/	磻
akl/	盼
akl/	泮
akl/	朌
akl/	攽
akl/	搫
akl/	扳
akl/	媻
akl/	蟠
akl/	胖
akl/	絆
akl/	礬
akl/	瘢
akl/	潘
akl/	槃
akl/	攀
akl/	拌
akl/	返
akl/	磐
akl/	盤
akl/	飯
akl/	頒
akl/	般
akl/	畔
akl/	班
akl/	斑
akl/	搬
akl/	叛
akl/	反
akl/	半
akl/	伴
aks/	鵓
aks/	鈸
aks/	醱
aks/	脖
aks/	潑
aks/	浡
aks/	哱
aks/	魃
aks/	髮
aks/	跋
aks/	發
aks/	渤
aks/	撥
aks/	拔
aks/	勃
aks/	鉢
akq/	龐
akq/	鎊
akq/	螃
akq/	舽
akq/	牓
akq/	梆
akq/	旊
akq/	搒
akq/	徬
akq/	幫
akq/	仿
akq/	昉
akq/	魴
akq/	髣
akq/	謗
akq/	蚌
akq/	蒡
akq/	舫
akq/	膀
akq/	磅
akq/	滂
akq/	榜
akq/	枋
akq/	旁
akq/	彷
akq/	幇
akq/	尨
akq/	厖
akq/	防
akq/	肪
akq/	紡
akq/	房
akq/	妨
akq/	坊
akq/	傍
akq/	邦
akq/	訪
akq/	芳
akq/	方
akq/	放
akq/	倣
ah/	褙
ah/	蓓
ah/	扒
ah/	坯
ah/	裵
ah/	裴
ah/	胚
ah/	琲
ah/	焙
ah/	湃
ah/	拜
ah/	徘
ah/	坏
ah/	北
ah/	陪
ah/	賠
ah/	培
ah/	倍
ah/	配
ah/	輩
ah/	背
ah/	盃
ah/	杯
ah/	排
ah/	俳
ahy/	魄
ahy/	粨
ahy/	帛
ahy/	佰
ahy/	百
ahy/	白
ahy/	柏
ahy/	伯
ahy/	栢
ajl/	蘩
ajl/	袢
ajl/	膰
ajl/	飜
ajl/	繙
ajl/	燔
ajl/	樊
ajl/	翻
ajl/	蕃
ajl/	番
ajl/	煩
ajl/	藩
ajl/	繁
ajl/	幡
ajs/	橃
ajs/	罸
ajs/	閥
ajs/	筏
ajs/	罰
ajs/	伐
ajo/	颿
ajo/	釩
ajo/	訉
ajo/	范
ajo/	笵
ajo/	泛
ajo/	梵
ajo/	凡
ajo/	範
ajo/	犯
ajo/	汎
ajo/	氾
ajo/	帆
aja/	琺
aja/	法
agy/	鼊
agy/	鷿
agy/	疈
agy/	擗
agy/	霹
agy/	闢
agy/	襞
agy/	甓
agy/	璧
agy/	蘗
agy/	檗
agy/	擘
agy/	劈
agy/	碧
agy/	癖
agy/	壁
agy/	僻
agl/	鴘
agl/	骿
agl/	賆
agl/	腁
agl/	籩
agl/	忭
agl/	駢
agl/	邊
agl/	辯
agl/	辮
agl/	變
agl/	抃
agl/	卞
agl/	辨
agl/	弁
agl/	便
ags/	鷩
ags/	鱉
ags/	彆
ags/	鼈
ags/	瞥
ags/	別
agq/	騈
agq/	鉼
agq/	鈵
agq/	輧
agq/	缾
agq/	棅
agq/	昺
agq/	拼
agq/	幷
agq/	屛
agq/	倂
agq/	甁
agq/	昞
agq/	餠
agq/	迸
agq/	絣
agq/	竝
agq/	秉
agq/	炳
agq/	並
agq/	柄
agq/	塀
agq/	兵
agq/	丙
agq/	鋲
agq/	病
an/	靌
an/	簠
an/	盙
an/	珤
an/	潽
an/	湺
an/	洑
an/	步
an/	俌
an/	黼
an/	褓
an/	葆
an/	寶
an/	堡
an/	報
an/	菩
an/	輔
an/	補
an/	甫
an/	保
an/	譜
an/	普
an/	鴇
any/	鵩
any/	菔
any/	扑
any/	幞
any/	宓
any/	墣
any/	鰒
any/	馥
any/	輹
any/	輻
any/	蝮
any/	蝠
any/	蔔
any/	茯
any/	箙
any/	濮
any/	匐
any/	卜
any/	僕
any/	覆
any/	複
any/	腹
any/	福
any/	服
any/	復
any/	伏
anl/	本
ans/	乶
anq/	鴌
anq/	綘
anq/	琫
anq/	熢
anq/	夆
anq/	丰
anq/	菶
anq/	篷
anq/	烽
anq/	棒
anq/	鳳
anq/	鋒
anq/	蜂
anq/	蓬
anq/	縫
anq/	捧
anq/	峯
anq/	峰
anq/	奉
anq/	俸
anq/	封
anq/	逢
at/	駙
at/	頫
at/	鈇
at/	跗
at/	裒
at/	袝
at/	蚨
at/	莩
at/	芣
at/	胕
at/	罦
at/	筟
at/	祔
at/	玞
at/	涪
at/	掊
at/	媍
at/	麩
at/	鳧
at/	趺
at/	賻
at/	訃
at/	蜉
at/	苻
at/	艀
at/	腑
at/	罘
at/	溥
at/	榑
at/	桴
at/	拊
at/	抔
at/	孵
at/	孚
at/	咐
at/	傅
at/	俯
at/	俘
at/	仆
at/	剖
at/	簿
at/	鮒
at/	覆
at/	復
at/	副
at/	部
at/	附
at/	阜
at/	赴
at/	賦
at/	負
at/	芙
at/	膚
at/	腐
at/	符
at/	父
at/	浮
at/	斧
at/	敷
at/	扶
at/	府
at/	富
at/	婦
at/	夫
at/	埠
at/	付
at/	不
at/	否
at/	蔀
at/	缶
at/	釜
aty/	北
atl/	鼢
atl/	黺
atl/	轒
atl/	蕡
atl/	膹
atl/	肦
atl/	砏
atl/	湓
atl/	棼
atl/	棻
atl/	昐
atl/	帉
atl/	坌
atl/	賁
atl/	芬
atl/	笨
atl/	畚
atl/	犇
atl/	濆
atl/	汾
atl/	氛
atl/	枌
atl/	忿
atl/	吩
atl/	盆
atl/	奔
atl/	雰
atl/	紛
atl/	糞
atl/	粉
atl/	奮
atl/	焚
atl/	扮
atl/	憤
atl/	墳
atl/	噴
atl/	分
atl/	体
ats/	韍
ats/	茀
ats/	艴
ats/	紱
ats/	岪
ats/	黻
ats/	髴
ats/	祓
ats/	拂
ats/	彿
ats/	佛
ats/	弗
ats/	不
atq/	鬅
atq/	漰
atq/	繃
atq/	硼
atq/	堋
atq/	鵬
atq/	朋
atq/	崩
atq/	棚
ai/	鼙
ai/	騛
ai/	騑
ai/	陴
ai/	閟
ai/	郫
ai/	邳
ai/	蚍
ai/	萆
ai/	芾
ai/	芘
ai/	痹
ai/	狉
ai/	濞
ai/	淠
ai/	淝
ai/	沘
ai/	毗
ai/	椑
ai/	棐
ai/	悱
ai/	庳
ai/	埤
ai/	圮
ai/	剕
ai/	仳
ai/	毖
ai/	髀
ai/	鞴
ai/	霏
ai/	鄙
ai/	贔
ai/	貔
ai/	譬
ai/	裨
ai/	蜚
ai/	蓖
ai/	菲
ai/	臂
ai/	腓
ai/	脾
ai/	翡
ai/	羆
ai/	紕
ai/	粃
ai/	篦
ai/	秕
ai/	祕
ai/	砒
ai/	睥
ai/	痺
ai/	痞
ai/	狒
ai/	榧
ai/	憊
ai/	屁
ai/	婢
ai/	妣
ai/	匕
ai/	俾
ai/	丕
ai/	沸
ai/	鼻
ai/	琵
ai/	毘
ai/	枇
ai/	備
ai/	飛
ai/	非
ai/	費
ai/	誹
ai/	肥
ai/	緋
ai/	秘
ai/	碑
ai/	泌
ai/	比
ai/	斐
ai/	批
ai/	扉
ai/	悲
ai/	庇
ai/	妃
ai/	卑
ai/	匪
ai/	轡
ail/	鬂
ail/	霦
ail/	鑌
ail/	邠
ail/	豳
ail/	臏
ail/	矉
ail/	玭
ail/	嚬
ail/	儐
ail/	份
ail/	鬢
ail/	顰
ail/	蘋
ail/	繽
ail/	濱
ail/	殯
ail/	檳
ail/	擯
ail/	嬪
ail/	牝
ail/	頻
ail/	賓
ail/	貧
ail/	瀕
ail/	浜
ail/	斌
ail/	彬
aiq/	靐
aiq/	凴
aiq/	騁
aiq/	聘
aiq/	憑
aiq/	娉
aiq/	凭
aiq/	冰
aiq/	氷
bk/	魦
bk/	蜡
bk/	缷
bk/	皶
bk/	痧
bk/	榭
bk/	楂
bk/	柶
bk/	姒
bk/	剚
bk/	僿
bk/	傞
bk/	汜
bk/	麝
bk/	鰤
bk/	鯊
bk/	駛
bk/	駟
bk/	辭
bk/	莎
bk/	舍
bk/	肆
bk/	耜
bk/	絲
bk/	篩
bk/	竢
bk/	祠
bk/	祀
bk/	瀉
bk/	渣
bk/	泗
bk/	梭
bk/	徙
bk/	寫
bk/	娑
bk/	奢
bk/	俟
bk/	蓑
bk/	巳
bk/	覗
bk/	乍
bk/	笥
bk/	邪
bk/	蛇
bk/	謝
bk/	紗
bk/	社
bk/	斜
bk/	赦
bk/	捨
bk/	射
bk/	寺
bk/	似
bk/	事
bk/	飼
bk/	賜
bk/	詞
bk/	私
bk/	獅
bk/	死
bk/	斯
bk/	思
bk/	師
bk/	士
bk/	四
bk/	嗣
bk/	史
bk/	司
bk/	使
bk/	伺
bk/	仕
bk/	咋
bk/	裟
bk/	詐
bk/	砂
bk/	沙
bk/	査
bk/	唆
bk/	些
bk/	卸
bky/	蒴
bky/	鑠
bky/	爍
bky/	槊
bky/	數
bky/	索
bky/	朔
bky/	削
bkl/	鏟
bkl/	訕
bkl/	狻
bkl/	澘
bkl/	毿
bkl/	橵
bkl/	孿
bkl/	姍
bkl/	剷
bkl/	霰
bkl/	閊
bkl/	繖
bkl/	疝
bkl/	潸
bkl/	汕
bkl/	刪
bkl/	蒜
bkl/	酸
bkl/	算
bkl/	産
bkl/	珊
bkl/	散
bkl/	山
bkl/	傘
bks/	煞
bks/	乷
bks/	撒
bks/	薩
bks/	殺
bko/	鬖
bko/	糝
bko/	渗
bko/	釤
bko/	衫
bko/	蔘
bko/	芟
bko/	參
bko/	杉
bko/	森
bko/	三
bka/	霅
bka/	鍤
bka/	鈒
bka/	翣
bka/	揷
bka/	唼
bka/	颯
bka/	霎
bka/	澁
bka/	歃
bka/	卅
bkq/	鬺
bkq/	顙
bkq/	鎟
bkq/	緗
bkq/	狀
bkq/	晌
bkq/	徜
bkq/	尙
bkq/	塽
bkq/	觴
bkq/	翔
bkq/	甞
bkq/	牀
bkq/	殤
bkq/	廂
bkq/	庠
bkq/	孀
bkq/	箱
bkq/	橡
bkq/	峠
bkq/	像
bkq/	霜
bkq/	相
bkq/	想
bkq/	爽
bkq/	喪
bkq/	常
bkq/	上
bkq/	賞
bkq/	象
bkq/	詳
bkq/	裳
bkq/	祥
bkq/	湘
bkq/	床
bkq/	嘗
bkq/	商
bkq/	償
bkq/	傷
bkq/	桑
bh/	鰓
bh/	賽
bh/	璽
bh/	塞
bhy/	瀒
bhy/	濇
bhy/	穡
bhy/	槭
bhy/	嗇
bhy/	色
bhy/	索
bhy/	塞
bhq/	眚
bhq/	鉎
bhq/	笙
bhq/	生
bhq/	牲
bhq/	省
bhq/	甥
bj/	鉏
bj/	諝
bj/	芧
bj/	紓
bj/	澨
bj/	湑
bj/	揟
bj/	捿
bj/	緖
bj/	胥
bj/	耡
bj/	絮
bj/	筮
bj/	敍
bj/	撕
bj/	抒
bj/	嶼
bj/	壻
bj/	墅
bj/	噬
bj/	舒
bj/	婿
bj/	鼠
bj/	逝
bj/	誓
bj/	西
bj/	栖
bj/	棲
bj/	瑞
bj/	鋤
bj/	恕
bj/	徐
bj/	序
bj/	薯
bj/	書
bj/	署
bj/	庶
bj/	曙
bj/	暑
bj/	犀
bj/	黍
bjy/	鼫
bjy/	舃
bjy/	腊
bjy/	矽
bjy/	奭
bjy/	晳
bjy/	鉐
bjy/	釋
bjy/	蜥
bjy/	蓆
bjy/	淅
bjy/	晰
bjy/	夕
bjy/	碩
bjy/	石
bjy/	析
bjy/	昔
bjy/	惜
bjy/	席
bjy/	錫
bjy/	汐
bjy/	潟
bjl/	鱻
bjl/	鱓
bjl/	騸
bjl/	饍
bjl/	鐥
bjl/	鏇
bjl/	譔
bjl/	詵
bjl/	蟬
bjl/	璿
bjl/	璇
bjl/	瑄
bjl/	琁
bjl/	熯
bjl/	渲
bjl/	歚
bjl/	敾
bjl/	屳
bjl/	尟
bjl/	嫙
bjl/	墡
bjl/	跣
bjl/	蘚
bjl/	譱
bjl/	綫
bjl/	筅
bjl/	禪
bjl/	癬
bjl/	愃
bjl/	尠
bjl/	嬋
bjl/	僊
bjl/	膳
bjl/	繕
bjl/	善
bjl/	鮮
bjl/	銑
bjl/	選
bjl/	船
bjl/	腺
bjl/	羨
bjl/	線
bjl/	旋
bjl/	煽
bjl/	扇
bjl/	宣
bjl/	先
bjl/	仙
bjs/	說
bjs/	稧
bjs/	碟
bjs/	爇
bjs/	暬
bjs/	揲
bjs/	媟
bjs/	卨
bjs/	偰
bjs/	齧
bjs/	褻
bjs/	薛
bjs/	紲
bjs/	渫
bjs/	泄
bjs/	楔
bjs/	舌
bjs/	雪
bjs/	設
bjs/	屑
bjs/	洩
bjo/	韱
bjo/	睒
bjo/	摻
bjo/	憸
bjo/	剡
bjo/	陝
bjo/	銛
bjo/	贍
bjo/	譫
bjo/	蟾
bjo/	纖
bjo/	殲
bjo/	暹
bjo/	孅
bjo/	閃
bja/	灄
bja/	涉
bja/	顳
bja/	鑷
bja/	躡
bja/	聶
bja/	攝
bja/	懾
bja/	囁
bja/	燮
bja/	葉
bjq/	騂
bjq/	瑆
bjq/	珹
bjq/	宬
bjq/	腥
bjq/	聲
bjq/	筬
bjq/	猩
bjq/	晟
bjq/	惺
bjq/	醒
bjq/	誠
bjq/	聖
bjq/	盛
bjq/	星
bjq/	成
bjq/	性
bjq/	姓
bjq/	城
bjq/	省
bp/	說
bp/	繐
bp/	稅
bp/	歲
bp/	帨
bp/	蛻
bp/	洒
bp/	貰
bp/	洗
bp/	勢
bp/	世
bp/	笹
bp/	細
bn/	魈
bn/	膆
bn/	翛
bn/	繅
bn/	箾
bn/	瘙
bn/	炤
bn/	搔
bn/	捎
bn/	巢
bn/	塐
bn/	埽
bn/	嗉
bn/	俏
bn/	佋
bn/	卲
bn/	鰺
bn/	鮹
bn/	騷
bn/	韶
bn/	霄
bn/	銷
bn/	酥
bn/	邵
bn/	逍
bn/	踈
bn/	蕭
bn/	蔬
bn/	艘
bn/	簫
bn/	筱
bn/	甦
bn/	燒
bn/	瀟
bn/	溯
bn/	泝
bn/	樔
bn/	梳
bn/	愬
bn/	嘯
bn/	蛸
bn/	掃
bn/	遡
bn/	訴
bn/	蘇
bn/	素
bn/	疎
bn/	疏
bn/	塑
bn/	紹
bn/	笑
bn/	消
bn/	沼
bn/	昭
bn/	少
bn/	小
bn/	宵
bn/	召
bn/	所
bn/	篠
bhy/	遬
bhy/	涑
bhy/	洬
bhy/	贖
bhy/	謖
bhy/	續
bhy/	屬
bhy/	俗
bhy/	速
bhy/	束
bhy/	粟
bnl/	飱
bnl/	飧
bnl/	飡
bnl/	蓀
bnl/	巽
bnl/	遜
bnl/	損
bnl/	孫
bns/	窣
bns/	蟀
bns/	率
bnq/	柗
bnq/	鬆
bnq/	頌
bnq/	誦
bnq/	竦
bnq/	淞
bnq/	悚
bnq/	送
bnq/	宋
bnq/	訟
bnq/	松
bnh/	曬
bnh/	惢
bnh/	碎
bnh/	瑣
bnh/	灑
bnh/	刷
bnh/	鎖
bs/	曬
bs/	惢
bs/	碎
bs/	瑣
bs/	灑
bs/	刷
bs/	鎖
bni/	釗
bni/	衰
bx/	釗
bx/	衰
bt/	饈
bt/	颼
bt/	膄
bt/	脺
bt/	繡
bt/	瞍
bt/	睢
bt/	睟
bt/	瘦
bt/	璲
bt/	濉
bt/	晬
bt/	廋
bt/	峀
bt/	琇
bt/	鬚
bt/	髓
bt/	隧
bt/	陲
bt/	銹
bt/	銖
bt/	隨
bt/	豎
bt/	讎
bt/	雖
bt/	藪
bt/	蓚
bt/	茱
bt/	膸
bt/	隋
bt/	脩
bt/	羞
bt/	綏
bt/	粹
bt/	籔
bt/	邃
bt/	穗
bt/	祟
bt/	獸
bt/	燧
bt/	漱
bt/	溲
bt/	洙
bt/	泅
bt/	殳
bt/	數
bt/	收
bt/	搜
bt/	戍
bt/	岫
bt/	嫂
bt/	壽
bt/	嗽
bt/	售
bt/	叟
bt/	輸
bt/	誰
bt/	竪
bt/	袖
bt/	遂
bt/	睡
bt/	水
bt/	帥
bt/	垂
bt/	須
bt/	酬
bt/	讐
bt/	蒐
bt/	秀
bt/	愁
bt/	修
bt/	囚
bt/	需
bt/	綬
bt/	樹
bt/	授
bt/	受
bt/	首
bt/	狩
bt/	殊
bt/	手
bt/	守
bty/	鷫
bty/	驌
bty/	璹
bty/	琡
bty/	潚
bty/	橚
bty/	婌
bty/	儵
bty/	菽
bty/	肅
bty/	倏
bty/	孰
bty/	俶
bty/	熟
bty/	塾
bty/	淑
bty/	宿
bty/	夙
bty/	叔
btl/	鬊
btl/	駨
btl/	肫
btl/	紃
btl/	眴
btl/	盹
btl/	狥
btl/	橓
btl/	栒
btl/	錞
btl/	珣
btl/	侚
btl/	鶉
btl/	諄
btl/	詢
btl/	蕣
btl/	蓴
btl/	荀
btl/	脣
btl/	筍
btl/	洵
btl/	恂
btl/	徇
btl/	馴
btl/	順
btl/	醇
btl/	巡
btl/	純
btl/	盾
btl/	淳
btl/	殉
btl/	楯
btl/	旬
btl/	循
btl/	舜
btl/	瞬
bts/	鉥
bts/	絉
bts/	戌
bts/	述
bts/	術
btq/	崧
btq/	菘
btq/	嵩
btq/	崇
bti/	焠
bti/	淬
bti/	倅
bd/	焠
bd/	淬
bd/	倅
bvs/	蝨
bvs/	虱
bvs/	瑟
bvs/	膝
bva/	熠
bva/	隰
bva/	褶
bva/	濕
bva/	慴
bva/	襲
bva/	習
bva/	拾
bvq/	鬙
bvq/	塍
bvq/	陞
bvq/	蠅
bvq/	繩
bvq/	乘
bvq/	僧
bvq/	丞
bvq/	昇
bvq/	承
bvq/	升
bvq/	勝
bi/	鍉
bi/	釃
bi/	豉
bi/	諰
bi/	翤
bi/	緦
bi/	澌
bi/	柹
bi/	枾
bi/	枲
bi/	媤
bi/	兕
bi/	諟
bi/	顋
bi/	豺
bi/	豕
bi/	諡
bi/	蓍
bi/	翅
bi/	猜
bi/	恃
bi/	弑
bi/	廝
bi/	屎
bi/	尸
bi/	塒
bi/	嘶
bi/	啻
bi/	厮
bi/	矢
bi/	是
bi/	柴
bi/	偲
bi/	蒔
bi/	示
bi/	時
bi/	侍
bi/	試
bi/	詩
bi/	視
bi/	施
bi/	市
bi/	屍
bi/	始
bi/	匙
biy/	篒
biy/	栻
biy/	媳
biy/	湜
biy/	軾
biy/	熄
biy/	寔
biy/	息
biy/	蝕
biy/	食
biy/	殖
biy/	植
biy/	拭
biy/	飾
biy/	埴
biy/	識
biy/	式
biy/	喰
bil/	駪
bil/	頣
bil/	藎
bil/	莘
bil/	脤
bil/	汛
bil/	姺
bil/	囟
bil/	侁
bil/	贐
bil/	蜃
bil/	燼
bil/	晨
bil/	愼
bil/	宸
bil/	哂
bil/	呻
bil/	噺
bil/	矧
bil/	辰
bil/	迅
bil/	訊
bil/	腎
bil/	辛
bil/	身
bil/	薪
bil/	臣
bil/	紳
bil/	神
bil/	申
bil/	新
bil/	娠
bil/	信
bil/	伸
bis/	飋
bis/	蟋
bis/	實
bis/	悉
bis/	室
bis/	失
bio/	鱏
bio/	葚
bio/	燖
bio/	梣
bio/	諶
bio/	鐔
bio/	瀋
bio/	潯
bio/	沁
bio/	沈
bio/	甚
bio/	尋
bio/	芯
bio/	深
bio/	心
bio/	審
bia/	辻
bia/	十
bia/	什
bia/	拾
bbkq/	雙
mkq/	雙
bbi/	氏
mi/	氏
qk/	迓
qk/	笌
qk/	砑
qk/	疴
qk/	娿
qk/	啞
qk/	丫
qk/	鵞
qk/	鵝
qk/	鴉
qk/	錏
qk/	訝
qk/	衙
qk/	莪
qk/	峩
qk/	婀
qk/	娥
qk/	哦
qk/	兒
qk/	亞
qk/	餓
qk/	雅
qk/	蛾
qk/	芽
qk/	牙
qk/	我
qk/	峨
qk/	俄
qk/	阿
qky/	覨
qky/	腭
qky/	噩
qky/	喔
qky/	卾
qky/	偓
qky/	齶
qky/	齷
qky/	鶚
qky/	鄂
qky/	諤
qky/	萼
qky/	樂
qky/	愕
qky/	惡
qky/	幄
qky/	嶽
qky/	堊
qky/	咢
qky/	鰐
qky/	鍔
qky/	顎
qky/	岳
qky/	渥
qky/	握
qkl/	犴
qkl/	桉
qkl/	鴈
qkl/	鮟
qkl/	晏
qkl/	顔
qkl/	雁
qkl/	贋
qkl/	眼
qkl/	岸
qkl/	鞍
qkl/	案
qkl/	按
qkl/	安
qks/	鴶
qks/	頞
qks/	穵
qks/	揠
qks/	嘎
qks/	閼
qks/	遏
qks/	軋
qks/	訐
qks/	戞
qks/	謁
qks/	斡
qko/	馣
qko/	蓭
qko/	葊
qko/	腤
qko/	晻
qko/	媕
qko/	啽
qko/	唵
qko/	嵓
qko/	黯
qko/	頷
qko/	諳
qko/	菴
qko/	巖
qko/	岩
qko/	癌
qko/	闇
qko/	暗
qko/	庵
qka/	狎
qka/	壓
qka/	鴨
qka/	押
qkq/	盎
qkq/	坱
qkq/	卬
qkq/	昻
qkq/	鴦
qkq/	鞅
qkq/	秧
qkq/	泱
qkq/	殃
qkq/	怏
qkq/	仰
qkq/	央
qh/	騃
qh/	薆
qh/	獃
qh/	漄
qh/	捱
qh/	娭
qh/	噯
qh/	唉
qh/	僾
qh/	厓
qh/	靉
qh/	靄
qh/	隘
qh/	藹
qh/	艾
qh/	礙
qh/	磑
qh/	瞹
qh/	睚
qh/	皚
qh/	欸
qh/	曖
qh/	崕
qh/	埃
qh/	啀
qh/	碍
qh/	涯
qh/	崖
qh/	挨
qh/	愛
qh/	哀
qhy/	搤
qhy/	戹
qhy/	呝
qhy/	阨
qhy/	腋
qhy/	縊
qhy/	掖
qhy/	扼
qhy/	厄
qhy/	額
qhy/	液
qhq/	鷪
qhq/	罃
qhq/	嫈
qhq/	鸚
qhq/	鶯
qhq/	罌
qhq/	櫻
qhq/	嚶
qf/	倻
qf/	椰
qf/	揶
qf/	野
qf/	耶
qf/	爺
qf/	夜
qf/	冶
qf/	也
qf/	埜
qf/	惹
qf/	若
qfy/	篛
qfy/	禴
qfy/	爚
qfy/	龠
qfy/	鶸
qfy/	鑰
qfy/	藥
qfy/	蒻
qfy/	葯
qfy/	籥
qfy/	躍
qfy/	約
qfy/	弱
qfy/	若
qfy/	鰯
qfq/	颺
qfq/	鑲
qfq/	輰
qfq/	蘘
qfq/	眻
qfq/	烊
qfq/	瀼
qfq/	敭
qfq/	徉
qfq/	驤
qfq/	釀
qfq/	讓
qfq/	襄
qfq/	穰
qfq/	禳
qfq/	癢
qfq/	瘍
qfq/	痒
qfq/	煬
qfq/	瀁
qfq/	漾
qfq/	樣
qfq/	暘
qfq/	攘
qfq/	恙
qfq/	孃
qfq/	壤
qfq/	佯
qfq/	養
qfq/	陽
qfq/	羊
qfq/	洋
qfq/	楊
qfq/	揚
qj/	瘀
qj/	敔
qj/	齬
qj/	馭
qj/	飫
qj/	淤
qj/	圉
qj/	圄
qj/	語
qj/	御
qj/	魚
qj/	禦
qj/	漁
qj/	於
qjy/	繶
qjy/	檍
qjy/	抑
qjy/	臆
qjy/	憶
qjy/	億
qjl/	鼹
qjl/	鼴
qjl/	鄢
qjl/	讞
qjl/	匽
qjl/	傿
qjl/	焉
qjl/	嫣
qjl/	偃
qjl/	彦
qjl/	諺
qjl/	言
qjl/	堰
qjs/	臬
qjs/	孼
qjs/	蘖
qjo/	醃
qjo/	曮
qjo/	崦
qjo/	閹
qjo/	罨
qjo/	淹
qjo/	广
qjo/	嚴
qjo/	儼
qjo/	俺
qjo/	掩
qjo/	奄
qja/	鄴
qja/	嶫
qja/	嶪
qja/	業
qp/	曀
qp/	恚
qpl/	円
qg/	轝
qg/	艅
qg/	礖
qg/	璵
qg/	餘
qg/	茹
qg/	與
qg/	舁
qg/	歟
qg/	輿
qg/	余
qg/	予
qg/	如
qg/	汝
qg/	女
qgy/	淢
qgy/	嶧
qgy/	驛
qgy/	閾
qgy/	譯
qgy/	繹
qgy/	懌
qgy/	役
qgy/	亦
qgy/	逆
qgy/	疫
qgy/	域
qgy/	易
qgl/	鷰
qgl/	輭
qgl/	蜵
qgl/	縯
qgl/	緣
qgl/	硏
qgl/	渷
qgl/	沇
qgl/	曣
qgl/	挻
qgl/	嬿
qgl/	姸
qgl/	堧
qgl/	埏
qgl/	囦
qgl/	兗
qgl/	讌
qgl/	蠕
qgl/	莚
qgl/	臙
qgl/	筵
qgl/	烟
qgl/	涎
qgl/	涓
qgl/	衍
qgl/	櫞
qgl/	椽
qgl/	掾
qgl/	捐
qgl/	悁
qgl/	娟
qgl/	嚥
qgl/	淵
qgl/	燃
qgl/	軟
qgl/	鳶
qgl/	然
qgl/	硯
qgl/	鉛
qgl/	燕
qgl/	煙
qgl/	演
qgl/	沿
qgl/	延
qgl/	宴
qgs/	閱
qgs/	說
qgs/	悅
qgs/	涅
qgs/	噎
qgs/	熱
qgs/	咽
qgo/	髥
qgo/	饜
qgo/	釅
qgo/	琰
qgo/	焰
qgo/	灩
qgo/	灎
qgo/	檿
qgo/	檶
qgo/	扊
qgo/	懕
qgo/	黶
qgo/	鹽
qgo/	魘
qgo/	閻
qgo/	苒
qgo/	冉
qgo/	染
qgo/	塩
qgo/	艶
qgo/	炎
qgo/	厭
qga/	爗
qga/	熀
qga/	曅
qga/	燁
qga/	靨
qga/	曄
qga/	葉
qgq/	韺
qgq/	縈
qgq/	碤
qgq/	癭
qgq/	煐
qgq/	瀯
qgq/	濴
qgq/	濚
qgq/	渶
qgq/	浧
qgq/	嬴
qgq/	嶸
qgq/	鍈
qgq/	霙
qgq/	郢
qgq/	贏
qgq/	蠑
qgq/	纓
qgq/	瓔
qgq/	瑩
qgq/	獰
qgq/	瀛
qgq/	潁
qgq/	榮
qgq/	楹
qgq/	暎
qgq/	塋
qgq/	營
qgq/	咏
qgq/	迎
qgq/	詠
qgq/	英
qgq/	穎
qgq/	盈
qgq/	瑛
qgq/	泳
qgq/	永
qgq/	映
qgq/	影
qgq/	嬰
qpp/	鷖
qpp/	銳
qpp/	蜺
qpp/	薉
qpp/	芮
qpp/	繄
qpp/	瞖
qpp/	獩
qpp/	濊
qpp/	汭
qpp/	枘
qpp/	掜
qpp/	拽
qpp/	嫛
qpp/	麑
qpp/	鯢
qpp/	霓
qpp/	譽
qpp/	裔
qpp/	蚋
qpp/	藝
qpp/	蕋
qpp/	蘂
qpp/	翳
qpp/	穢
qpp/	睿
qpp/	睨
qpp/	猊
qpp/	囈
qpp/	倪
qpp/	豫
qpp/	乂
qpp/	預
qpp/	蕊
qpp/	詣
qpp/	苅
qpp/	刈
qpp/	曳
qpp/	叡
qq/	鷖
qq/	銳
qq/	蜺
qq/	薉
qq/	芮
qq/	繄
qq/	瞖
qq/	獩
qq/	濊
qq/	汭
qq/	枘
qq/	掜
qq/	拽
qq/	嫛
qq/	麑
qq/	鯢
qq/	霓
qq/	譽
qq/	裔
qq/	蚋
qq/	藝
qq/	蕋
qq/	蘂
qq/	翳
qq/	穢
qq/	睿
qq/	睨
qq/	猊
qq/	囈
qq/	倪
qq/	豫
qq/	乂
qq/	預
qq/	蕊
qq/	詣
qq/	苅
qq/	刈
qq/	曳
qq/	叡
qn/	鼯
qn/	驁
qn/	隩
qn/	鏊
qn/	迕
qn/	迃
qn/	謷
qn/	聱
qn/	筽
qn/	窹
qn/	獒
qn/	汙
qn/	旿
qn/	捂
qn/	慠
qn/	嫯
qn/	媪
qn/	娛
qn/	圬
qn/	噁
qn/	吳
qn/	仵
qn/	俉
qn/	鼇
qn/	鰲
qn/	鏖
qn/	遨
qn/	蜈
qn/	茣
qn/	熬
qn/	澳
qn/	晤
qn/	敖
qn/	懊
qn/	惡
qn/	忤
qn/	寤
qn/	奧
qn/	墺
qn/	塢
qn/	嗷
qn/	嗚
qn/	唔
qn/	傲
qn/	俣
qn/	誤
qn/	梧
qn/	悟
qn/	吾
qn/	午
qn/	伍
qn/	五
qn/	襖
qn/	汚
qn/	烏
qny/	鈺
qny/	沃
qny/	獄
qny/	玉
qny/	屋
qnl/	韞
qnl/	醞
qnl/	轀
qnl/	縕
qnl/	瑥
qnl/	熅
qnl/	溫
qnl/	氳
qnl/	昷
qnl/	鰮
qnl/	饂
qnl/	蘊
qnl/	薀
qnl/	穩
qnl/	瘟
qnl/	慍
qnl/	媼
qns/	嗢
qns/	膃
qns/	兀
qnq/	饔
qnq/	顒
qnq/	雝
qnq/	邕
qnq/	罋
qnq/	癕
qnq/	滃
qnq/	喁
qnq/	雍
qnq/	蓊
qnq/	禺
qnq/	癰
qnq/	甕
qnq/	瓮
qnq/	廱
qnq/	壅
qnq/	擁
qnq/	翁
qnk/	窊
qnk/	猧
qnk/	洼
qnk/	枙
qnk/	婐
qnk/	譌
qnk/	訛
qnk/	蝸
qnk/	萵
qnk/	窩
qnk/	囮
qnk/	哇
qnk/	窪
qnk/	瓦
qnk/	蛙
qnk/	臥
qnk/	渦
qe/	窊
qe/	猧
qe/	洼
qe/	枙
qe/	婐
qe/	譌
qe/	訛
qe/	蝸
qe/	萵
qe/	窩
qe/	囮
qe/	哇
qe/	窪
qe/	瓦
qe/	蛙
qe/	臥
qe/	渦
qnkl/	脘
qnkl/	盌
qnkl/	琬
qnkl/	琓
qnkl/	涴
qnkl/	梡
qnkl/	惋
qnkl/	忨
qnkl/	岏
qnkl/	妧
qnkl/	垸
qnkl/	刓
qnkl/	阮
qnkl/	豌
qnkl/	浣
qnkl/	婉
qnkl/	腕
qnkl/	碗
qnkl/	椀
qnkl/	頑
qnkl/	翫
qnkl/	玩
qnkl/	莞
qnkl/	緩
qnkl/	完
qnkl/	宛
qel/	脘
qel/	盌
qel/	琬
qel/	琓
qel/	涴
qel/	梡
qel/	惋
qel/	忨
qel/	岏
qel/	妧
qel/	垸
qel/	刓
qel/	阮
qel/	豌
qel/	浣
qel/	婉
qel/	腕
qel/	碗
qel/	椀
qel/	頑
qel/	翫
qel/	玩
qel/	莞
qel/	緩
qel/	完
qel/	宛
qnks/	曰
qes/	曰
qnkq/	迬
qnkq/	尫
qnkq/	瀇
qnkq/	汪
qnkq/	枉
qnkq/	王
qnkq/	旺
qnkq/	往
qeq/	迬
qeq/	尫
qeq/	瀇
qeq/	汪
qeq/	枉
qeq/	王
qeq/	旺
qeq/	往
qnh/	媧
qnh/	矮
qnh/	歪
qnh/	倭
qnh/	娃
qs/	媧
qs/	矮
qs/	歪
qs/	倭
qs/	娃
qni/	聵
qni/	磈
qni/	碨
qni/	煨
qni/	渨
qni/	嵔
qni/	崴
qni/	偎
qni/	隗
qni/	猥
qni/	巍
qni/	嵬
qni/	外
qni/	畏
qx/	聵
qx/	磈
qx/	碨
qx/	煨
qx/	渨
qx/	嵔
qx/	崴
qx/	偎
qx/	隗
qx/	猥
qx/	巍
qx/	嵬
qx/	外
qx/	畏
qm/	繇
qm/	窅
qm/	穾
qm/	祅
qm/	嬈
qm/	墝
qm/	坳
qm/	喓
qm/	偠
qm/	瑤
qm/	遙
qm/	堯
qm/	鷂
qm/	饒
qm/	邀
qm/	遶
qm/	謠
qm/	蟯
qm/	蕘
qm/	繞
qm/	窈
qm/	燿
qm/	澆
qm/	殀
qm/	橈
qm/	樂
qm/	撓
qm/	搖
qm/	拗
qm/	徼
qm/	徭
qm/	幺
qm/	嶢
qm/	寥
qm/	姚
qm/	夭
qm/	僥
qm/	要
qm/	耀
qm/	窯
qm/	曜
qm/	妖
qm/	擾
qm/	腰
qm/	凹
qmy/	褥
qmy/	蓐
qmy/	縟
qmy/	溽
qmy/	浴
qmy/	欲
qmy/	慾
qmy/	辱
qmq/	硧
qmq/	槦
qmq/	憃
qmq/	嵱
qmq/	宂
qmq/	墉
qmq/	傛
qmq/	鏞
qmq/	瑢
qmq/	埇
qmq/	鎔
qmq/	踴
qmq/	蛹
qmq/	舂
qmq/	聳
qmq/	甬
qmq/	榕
qmq/	慵
qmq/	慂
qmq/	俑
qmq/	踊
qmq/	蓉
qmq/	用
qmq/	熔
qmq/	溶
qmq/	庸
qmq/	容
qmq/	傭
qmq/	涌
qmq/	湧
qmq/	勇
qmq/	茸
qmq/	冗
qt/	麀
qt/	雩
qt/	鍝
qt/	釪
qt/	踽
qt/	謣
qt/	耰
qt/	耦
qt/	竽
qt/	禑
qt/	盱
qt/	瑀
qt/	玗
qt/	杅
qt/	旴
qt/	庽
qt/	堣
qt/	偊
qt/	俁
qt/	亴
qt/	亏
qt/	齲
qt/	麌
qt/	藕
qt/	紆
qt/	禹
qt/	盂
qt/	疣
qt/	嵎
qt/	吁
qt/	于
qt/	郵
qt/	祐
qt/	憂
qt/	友
qt/	優
qt/	佑
qt/	尤
qt/	又
qt/	隅
qt/	遇
qt/	寓
qt/	偶
qt/	虞
qt/	愚
qt/	牛
qt/	雨
qt/	迂
qt/	羽
qt/	宇
qt/	右
qt/	芋
qty/	頊
qty/	稶
qty/	栯
qty/	勖
qty/	煜
qty/	彧
qty/	昱
qty/	燠
qty/	郁
qty/	旭
qtl/	霣
qtl/	篔
qtl/	熉
qtl/	澐
qtl/	沄
qtl/	橒
qtl/	蕓
qtl/	惲
qtl/	韵
qtl/	隕
qtl/	耘
qtl/	紜
qtl/	殞
qtl/	暈
qtl/	芸
qtl/	雲
qtl/	運
qtl/	云
qtl/	韻
qts/	亐
qts/	鬱
qts/	蔚
qtq/	雄
qtq/	熊
qtjl/	黿
qtjl/	鵷
qtjl/	騵
qtjl/	謜
qtjl/	綩
qtjl/	瑗
qtjl/	猨
qtjl/	洹
qtjl/	沅
qtjl/	楥
qtjl/	杬
qtjl/	嫄
qtjl/	阮
qtjl/	鋺
qtjl/	轅
qtjl/	袁
qtjl/	蜿
qtjl/	芫
qtjl/	爰
qtjl/	湲
qtjl/	愿
qtjl/	寃
qtjl/	圜
qtjl/	圓
qtjl/	冤
qtjl/	媛
qtjl/	源
qtjl/	原
qtjl/	元
qtjl/	願
qtjl/	垣
qtjl/	鴛
qtjl/	遠
qtjl/	薗
qtjl/	苑
qtjl/	猿
qtjl/	援
qtjl/	怨
qtjl/	園
qtjl/	院
qtjl/	員
qal/	黿
qal/	鵷
qal/	騵
qal/	謜
qal/	綩
qal/	瑗
qal/	猨
qal/	洹
qal/	沅
qal/	楥
qal/	杬
qal/	嫄
qal/	阮
qal/	鋺
qal/	轅
qal/	袁
qal/	蜿
qal/	芫
qal/	爰
qal/	湲
qal/	愿
qal/	寃
qal/	圜
qal/	圓
qal/	冤
qal/	媛
qal/	源
qal/	原
qal/	元
qal/	願
qal/	垣
qal/	鴛
qal/	遠
qal/	薗
qal/	苑
qal/	猿
qal/	援
qal/	怨
qal/	園
qal/	院
qal/	員
qtjs/	粵
qtjs/	刖
qtjs/	鉞
qtjs/	粤
qtjs/	月
qtjs/	越
qas/	粵
qas/	刖
qas/	鉞
qas/	粤
qas/	月
qas/	越
qti/	骪
qti/	韡
qti/	韙
qti/	闈
qti/	諉
qti/	褘
qti/	蔿
qti/	葳
qti/	瑋
qti/	煒
qti/	暐
qti/	餧
qti/	魏
qti/	韋
qti/	逶
qti/	衞
qti/	蝟
qti/	痿
qti/	爲
qti/	熨
qti/	渭
qti/	幃
qti/	圍
qti/	喟
qti/	僞
qti/	危
qti/	衛
qti/	違
qti/	謂
qti/	萎
qti/	胃
qti/	緯
qti/	慰
qti/	尉
qti/	威
qti/	委
qti/	偉
qti/	位
qti/	葦
qd/	骪
qd/	韡
qd/	韙
qd/	闈
qd/	諉
qd/	褘
qd/	蔿
qd/	葳
qd/	瑋
qd/	煒
qd/	暐
qd/	餧
qd/	魏
qd/	韋
qd/	逶
qd/	衞
qd/	蝟
qd/	痿
qd/	爲
qd/	熨
qd/	渭
qd/	幃
qd/	圍
qd/	喟
qd/	僞
qd/	危
qd/	衛
qd/	違
qd/	謂
qd/	萎
qd/	胃
qd/	緯
qd/	慰
qd/	尉
qd/	威
qd/	委
qd/	偉
qd/	位
qd/	葦
qr/	龥
qr/	逌
qr/	讉
qr/	褕
qr/	蝤
qr/	蚴
qr/	蕤
qr/	緌
qr/	籲
qr/	窳
qr/	窬
qr/	瘐
qr/	牖
qr/	洧
qr/	泑
qr/	斿
qr/	庾
qr/	壝
qr/	呦
qr/	冘
qr/	鼬
qr/	黝
qr/	鞣
qr/	鍮
qr/	釉
qr/	逾
qr/	踰
qr/	蹂
qr/	諛
qr/	蚰
qr/	蕕
qr/	萸
qr/	莠
qr/	臾
qr/	腴
qr/	糅
qr/	瘉
qr/	瑜
qr/	游
qr/	楡
qr/	攸
qr/	揄
qr/	揉
qr/	帷
qr/	孺
qr/	囿
qr/	喩
qr/	兪
qr/	侑
qr/	幼
qr/	遊
qr/	誘
qr/	裕
qr/	由
qr/	猷
qr/	猶
qr/	柚
qr/	有
qr/	悠
qr/	幽
qr/	宥
qr/	唯
qr/	諭
qr/	癒
qr/	油
qr/	愈
qr/	愉
qr/	鮪
qr/	濡
qr/	乳
qr/	楢
qr/	酉
qr/	柔
qr/	儒
qr/	遺
qr/	維
qr/	惟
qry/	堉
qry/	儥
qry/	毓
qry/	肉
qry/	育
qrl/	鋆
qrl/	鈗
qrl/	玧
qrl/	奫
qrl/	昀
qrl/	贇
qrl/	尹
qrl/	潤
qrl/	閏
qrl/	胤
qrl/	允
qrs/	矞
qrs/	潏
qrs/	聿
qrq/	狨
qrq/	瀜
qrq/	絨
qrq/	融
qrq/	戎
qvl/	齗
qvl/	鄞
qvl/	訔
qvl/	癮
qvl/	珢
qvl/	狺
qvl/	溵
qvl/	檼
qvl/	垽
qvl/	圁
qvl/	嚚
qvl/	嗯
qvl/	誾
qvl/	隱
qvl/	殷
qvl/	憖
qvl/	慇
qvl/	垠
qvl/	听
qvl/	銀
qvl/	恩
qvs/	鳦
qvs/	乙
qvo/	愔
qvo/	廕
qvo/	喑
qvo/	霪
qvo/	飮
qvo/	崟
qvo/	吟
qvo/	音
qvo/	陰
qvo/	蔭
qvo/	淫
qva/	浥
qva/	挹
qva/	悒
qva/	邑
qva/	揖
qva/	泣
qvq/	膺
qvq/	應
qvq/	鷹
qvq/	凝
qvi/	螘
qvi/	薏
qvi/	漪
qvi/	劓
qvi/	凒
qvi/	儗
qvi/	饐
qvi/	醫
qvi/	艤
qvi/	礒
qvi/	矣
qvi/	猗
qvi/	欹
qvi/	懿
qvi/	嶷
qvi/	倚
qvi/	議
qvi/	誼
qvi/	蟻
qvi/	義
qvi/	疑
qvi/	擬
qvi/	宜
qvi/	儀
qvi/	毅
qvi/	衣
qvi/	椅
qvi/	意
qvi/	依
ql/	螘
ql/	薏
ql/	漪
ql/	劓
ql/	凒
ql/	儗
ql/	饐
ql/	醫
ql/	艤
ql/	礒
ql/	矣
ql/	猗
ql/	欹
ql/	懿
ql/	嶷
ql/	倚
ql/	議
ql/	誼
ql/	蟻
ql/	義
ql/	疑
ql/	擬
ql/	宜
ql/	儀
ql/	毅
ql/	衣
ql/	椅
ql/	意
ql/	依
qi/	迤
qi/	訑
qi/	荑
qi/	珆
qi/	栮
qi/	彛
qi/	尔
qi/	坨
qi/	咿
qi/	隶
qi/	邇
qi/	貳
qi/	貽
qi/	苡
qi/	肄
qi/	痍
qi/	珥
qi/	洟
qi/	怡
qi/	彝
qi/	已
qi/	姨
qi/	二
qi/	弛
qi/	詑
qi/	耳
qi/	而
qi/	爾
qi/	餌
qi/	移
qi/	異
qi/	易
qi/	夷
qi/	伊
qi/	以
qi/	飴
qiy/	熤
qiy/	瀷
qiy/	鷁
qiy/	謚
qiy/	翊
qiy/	弋
qiy/	翼
qiy/	翌
qiy/	益
qil/	靷
qil/	裀
qil/	芢
qil/	絪
qil/	禋
qil/	洇
qil/	婣
qil/	夤
qil/	蚓
qil/	茵
qil/	湮
qil/	氤
qil/	扨
qil/	堙
qil/	仞
qil/	籾
qil/	認
qil/	忍
qil/	寅
qil/	靭
qil/	刃
qil/	仁
qil/	人
qil/	引
qil/	姻
qil/	因
qil/	咽
qil/	印
qis/	馹
qis/	泆
qis/	佾
qis/	鎰
qis/	軼
qis/	壹
qis/	佚
qis/	日
qis/	逸
qis/	溢
qis/	一
qio/	飪
qio/	銋
qio/	絍
qio/	媵
qio/	衽
qio/	恁
qio/	姙
qio/	稔
qio/	妊
qio/	任
qio/	賃
qio/	壬
qio/	荏
qia/	卄
qia/	入
qia/	廿
qiq/	芿
qiq/	孕
qiq/	剩
qiq/	仍
uk/	鶿
uk/	頿
uk/	鎡
uk/	訾
uk/	虸
uk/	莿
uk/	茈
uk/	胾
uk/	耔
uk/	玆
uk/	牸
uk/	孶
uk/	嬨
uk/	泚
uk/	孖
uk/	鷓
uk/	鮓
uk/	赭
uk/	貲
uk/	觜
uk/	藉
uk/	蔗
uk/	茲
uk/	粢
uk/	眦
uk/	眥
uk/	疵
uk/	瓷
uk/	炙
uk/	恣
uk/	咨
uk/	呰
uk/	髭
uk/	柘
uk/	者
uk/	煮
uk/	自
uk/	磁
uk/	滋
uk/	慈
uk/	字
uk/	雌
uk/	資
uk/	諮
uk/	紫
uk/	孜
uk/	子
uk/	姿
uk/	姉
uk/	刺
uk/	仔
uk/	茨
uky/	碏
uky/	犳
uky/	焯
uky/	汋
uky/	斱
uky/	怍
uky/	岝
uky/	鵲
uky/	芍
uky/	綽
uky/	炸
uky/	柞
uky/	斫
uky/	嚼
uky/	雀
uky/	酌
uky/	爵
uky/	灼
uky/	勺
uky/	昨
uky/	作
ukl/	驏
ukl/	剗
ukl/	盞
ukl/	潺
ukl/	殘
ukl/	棧
ukl/	戔
ukl/	孱
uko/	涔
uko/	蠶
uko/	簪
uko/	箴
uko/	濳
uko/	潛
uko/	岑
uko/	潜
uko/	暫
uka/	磼
uka/	眨
uka/	卡
uka/	雜
uka/	襍
uka/	囃
ukq/	麞
ukq/	餦
ukq/	醬
ukq/	鄣
ukq/	賬
ukq/	蔣
ukq/	羘
ukq/	糚
ukq/	獐
ukq/	牂
ukq/	漳
ukq/	欌
ukq/	戕
ukq/	廧
ukq/	嬙
ukq/	傽
ukq/	暲
ukq/	鏘
ukq/	贓
ukq/	裝
ukq/	藏
ukq/	薔
ukq/	萇
ukq/	莊
ukq/	臧
ukq/	臟
ukq/	瘴
ukq/	璋
ukq/	牆
ukq/	漿
ukq/	檣
ukq/	嶂
ukq/	將
ukq/	妝
ukq/	奬
ukq/	奘
ukq/	壯
ukq/	墻
ukq/	仗
ukq/	長
ukq/	腸
ukq/	張
ukq/	帳
ukq/	装
ukq/	葬
ukq/	杖
ukq/	場
ukq/	丈
ukq/	障
ukq/	粧
ukq/	章
ukq/	樟
ukq/	掌
ukq/	庄
ukq/	匠
uh/	灾
uh/	渽
uh/	榟
uh/	扗
uh/	崽
uh/	夈
uh/	齎
uh/	纔
uh/	縡
uh/	齋
uh/	滓
uh/	財
uh/	材
uh/	在
uh/	載
uh/	裁
uh/	災
uh/	栽
uh/	才
uh/	宰
uh/	哉
uh/	再
uh/	梓
uhq/	琤
uhq/	猙
uhq/	錚
uhq/	諍
uhq/	箏
uhq/	爭
uhq/	崢
uhq/	鎗
uj/	陼
uj/	褚
uj/	袛
uj/	菹
uj/	罝
uj/	氐
uj/	宁
uj/	齟
uj/	雎
uj/	躇
uj/	豬
uj/	詆
uj/	詛
uj/	觝
uj/	蛆
uj/	苴
uj/	羝
uj/	紵
uj/	疽
uj/	牴
uj/	潴
uj/	沮
uj/	楮
uj/	柢
uj/	杼
uj/	咀
uj/	佇
uj/	儲
uj/	箸
uj/	這
uj/	邸
uj/	抵
uj/	底
uj/	低
uj/	貯
uj/	著
uj/	苧
uj/	猪
uj/	瀦
uj/	樗
uj/	狙
uj/	岨
uj/	藷
uj/	渚
uj/	杵
uj/	姐
ujy/	馰
ujy/	菂
ujy/	翟
ujy/	樀
ujy/	逖
ujy/	迹
ujy/	迪
ujy/	謫
ujy/	覿
ujy/	糴
ujy/	磧
ujy/	狄
ujy/	勣
ujy/	鏑
ujy/	適
ujy/	笛
ujy/	的
ujy/	滴
ujy/	敵
ujy/	摘
ujy/	吊
ujy/	嫡
ujy/	賊
ujy/	蹟
ujy/	跡
ujy/	赤
ujy/	績
ujy/	籍
ujy/	積
ujy/	寂
ujy/	荻
ujl/	鸇
ujl/	鱣
ujl/	鬋
ujl/	餰
ujl/	飦
ujl/	顚
ujl/	顓
ujl/	靛
ujl/	錪
ujl/	鋑
ujl/	鄽
ujl/	邅
ujl/	輇
ujl/	荃
ujl/	膞
ujl/	籛
ujl/	瑱
ujl/	琠
ujl/	澶
ujl/	湔
ujl/	戩
ujl/	屇
ujl/	嫥
ujl/	塼
ujl/	塡
ujl/	佺
ujl/	槇
ujl/	餞
ujl/	顫
ujl/	靦
ujl/	鐫
ujl/	錢
ujl/	銓
ujl/	鈿
ujl/	轉
ujl/	輾
ujl/	躔
ujl/	腆
ujl/	翦
ujl/	羶
ujl/	篆
ujl/	箋
ujl/	筌
ujl/	磚
ujl/	癲
ujl/	癜
ujl/	痊
ujl/	甎
ujl/	牋
ujl/	氈
ujl/	旃
ujl/	畋
ujl/	戰
ujl/	悛
ujl/	廛
ujl/	巓
ujl/	專
ujl/	奠
ujl/	囀
ujl/	吮
ujl/	甸
ujl/	剪
ujl/	傳
ujl/	畠
ujl/	畑
ujl/	電
ujl/	田
ujl/	澱
ujl/	殿
ujl/	纏
ujl/	展
ujl/	典
ujl/	佃
ujl/	揃
ujl/	全
ujl/	前
ujl/	詮
ujl/	箭
ujl/	煎
ujl/	栴
ujl/	栓
ujs/	癤
ujs/	岊
ujs/	竊
ujs/	浙
ujs/	晢
ujs/	截
ujs/	絶
ujs/	節
ujs/	窃
ujs/	折
ujs/	切
ujo/	颭
ujo/	蛅
ujo/	蔪
ujo/	玷
ujo/	墊
ujo/	佔
ujo/	點
ujo/	黏
ujo/	霑
ujo/	覘
ujo/	簟
ujo/	笘
ujo/	岾
ujo/	粘
ujo/	苫
ujo/	点
ujo/	店
ujo/	漸
ujo/	占
ujo/	鮎
uja/	蹀
uja/	跕
uja/	蜨
uja/	鰈
uja/	楪
uja/	椄
uja/	蝶
uja/	接
uja/	摺
ujq/	靚
ujq/	鋥
ujq/	鋌
ujq/	諪
ujq/	莛
ujq/	綎
ujq/	筳
ujq/	珽
ujq/	玎
ujq/	炡
ujq/	湞
ujq/	檉
ujq/	棖
ujq/	桯
ujq/	晸
ujq/	怔
ujq/	婷
ujq/	婧
ujq/	姃
ujq/	佂
ujq/	珵
ujq/	楨
ujq/	靜
ujq/	霆
ujq/	酲
ujq/	酊
ujq/	遉
ujq/	穽
ujq/	睛
ujq/	疔
ujq/	渟
ujq/	淨
ujq/	梃
ujq/	旌
ujq/	掟
ujq/	幀
ujq/	叮
ujq/	淀
ujq/	靖
ujq/	柾
ujq/	瀞
ujq/	灯
ujq/	鼎
ujq/	釘
ujq/	鄭
ujq/	訂
ujq/	艇
ujq/	程
ujq/	禎
ujq/	碇
ujq/	汀
ujq/	挺
ujq/	廷
ujq/	庭
ujq/	定
ujq/	呈
ujq/	貞
ujq/	偵
ujq/	停
ujq/	亭
ujq/	頂
ujq/	町
ujq/	丁
ujq/	精
ujq/	正
ujq/	整
ujq/	政
ujq/	征
ujq/	錠
ujq/	情
ujq/	鉦
ujq/	証
ujq/	晶
ujq/	井
up/	鯷
up/	鮧
up/	隄
up/	蹏
up/	踶
up/	緹
up/	稊
up/	瑅
up/	猘
up/	娣
up/	鍗
up/	禔
up/	齊
up/	韲
up/	霽
up/	躋
up/	薺
up/	臍
up/	睇
up/	濟
up/	擠
up/	啼
up/	劑
up/	儕
up/	蹄
up/	梯
up/	提
up/	悌
up/	弟
up/	帝
up/	堤
up/	題
up/	醍
up/	第
up/	製
up/	制
up/	除
up/	諸
up/	際
up/	祭
un/	鼂
un/	鋽
un/	鈟
un/	臊
un/	絩
un/	糙
un/	祧
un/	皁
un/	璪
un/	琱
un/	殂
un/	嬥
un/	嘈
un/	厝
un/	刁
un/	傮
un/	鵰
un/	曺
un/	雕
un/	躁
un/	趙
un/	譟
un/	誂
un/	蜩
un/	艚
un/	胙
un/	絛
un/	糶
un/	笊
un/	竈
un/	窕
un/	稠
un/	祚
un/	澡
un/	棗
un/	條
un/	晁
un/	找
un/	懆
un/	徂
un/	噪
un/	嘲
un/	俎
un/	佻
un/	肇
un/	蚤
un/	釣
un/	爪
un/	蔦
un/	鳥
un/	銚
un/	調
un/	眺
un/	潮
un/	朝
un/	彫
un/	弔
un/	凋
un/	兆
un/	鯛
un/	造
un/	遭
un/	走
un/	藻
un/	糟
un/	燥
un/	漕
un/	槽
un/	曹
un/	早
un/	操
un/	阻
un/	組
un/	粗
un/	租
un/	祖
un/	措
un/	詔
un/	照
un/	助
un/	繰
uny/	瘯
uny/	鏃
uny/	簇
uny/	族
uny/	足
unl/	拵
unl/	尊
unl/	存
uns/	猝
uns/	卒
uns/	拙
unq/	瘇
unq/	瑽
unq/	慒
unq/	悰
unq/	倧
unq/	琮
unq/	伀
unq/	踪
unq/	蹤
unq/	踵
unq/	螽
unq/	縱
unq/	粽
unq/	淙
unq/	樅
unq/	椶
unq/	棕
unq/	慫
unq/	從
unq/	柊
unq/	綜
unq/	鐘
unq/	鍾
unq/	終
unq/	宗
unq/	腫
unq/	種
unk/	髽
unk/	莝
unk/	痤
unk/	剉
unk/	挫
unk/	座
unk/	坐
unk/	左
unk/	佐
ue/	髽
ue/	莝
ue/	痤
ue/	剉
ue/	挫
ue/	座
ue/	坐
ue/	左
ue/	佐
uni/	罪
ux/	罪
ut/	鼄
ut/	霔
ut/	霌
ut/	鉒
ut/	輈
ut/	趎
ut/	賙
ut/	詋
ut/	裯
ut/	蛀
ut/	腠
ut/	籒
ut/	硃
ut/	炷
ut/	澍
ut/	拄
ut/	幬
ut/	尌
ut/	姝
ut/	侜
ut/	丟
ut/	鑄
ut/	遒
ut/	輳
ut/	躊
ut/	誅
ut/	蛛
ut/	蔟
ut/	胄
ut/	綢
ut/	紂
ut/	籌
ut/	疇
ut/	晝
ut/	廚
ut/	嗾
ut/	儔
ut/	做
ut/	侏
ut/	湊
ut/	肘
ut/	紬
ut/	駐
ut/	酎
ut/	註
ut/	注
ut/	柱
ut/	宙
ut/	奏
ut/	住
ut/	週
ut/	舟
ut/	洲
ut/	州
ut/	周
ut/	呪
ut/	酒
ut/	珠
ut/	朱
ut/	主
ut/	株
uty/	竹
uty/	粥
utl/	鵔
utl/	餕
utl/	鐏
utl/	踆
utl/	綧
utl/	焌
utl/	撙
utl/	寯
utl/	埻
utl/	茁
utl/	罇
utl/	畯
utl/	晙
utl/	埈
utl/	雋
utl/	逡
utl/	蹲
utl/	蠢
utl/	皴
utl/	濬
utl/	浚
utl/	惷
utl/	墫
utl/	儁
utl/	鱒
utl/	隼
utl/	樽
utl/	遵
utl/	準
utl/	准
utl/	駿
utl/	竣
utl/	峻
utl/	俊
utl/	噂
uts/	乼
utq/	眾
utq/	仲
utq/	中
utq/	重
utq/	衆
uvy/	卽
uvy/	喞
uvy/	即
uvs/	騭
uvs/	櫛
uva/	蕺
uva/	檝
uva/	楫
uva/	葺
uva/	汁
uvq/	罾
uvq/	矰
uvq/	嶒
uvq/	繒
uvq/	增
uvq/	證
uvq/	烝
uvq/	拯
uvq/	贈
uvq/	憎
uvq/	曾
uvq/	蒸
uvq/	症
uvq/	甑
ui/	軹
ui/	芷
ui/	篪
ui/	秪
ui/	泜
ui/	榰
ui/	扺
ui/	墀
ui/	坻
ui/	鷙
ui/	鮨
ui/	阯
ui/	遲
ui/	躓
ui/	踟
ui/	趾
ui/	贄
ui/	舐
ui/	祗
ui/	痣
ui/	沚
ui/	枳
ui/	摯
ui/	址
ui/	咫
ui/	之
ui/	砥
ui/	漬
ui/	蜘
ui/	池
ui/	智
ui/	地
ui/	知
ui/	只
ui/	芝
ui/	識
ui/	持
ui/	誌
ui/	至
ui/	脂
ui/	肢
ui/	紙
ui/	祉
ui/	止
ui/	枝
ui/	旨
ui/	支
ui/	指
ui/	志
uiy/	稷
uiy/	稙
uiy/	禝
uiy/	直
uiy/	職
uiy/	織
uil/	鬒
uil/	鉁
uil/	螴
uil/	蔯
uil/	縝
uil/	稹
uil/	璡
uil/	瑨
uil/	溱
uil/	桭
uil/	搢
uil/	侲
uil/	珒
uil/	鎭
uil/	軫
uil/	趁
uil/	袗
uil/	蓁
uil/	臻
uil/	縉
uil/	瞋
uil/	眞
uil/	盡
uil/	畛
uil/	殄
uil/	晉
uil/	嗔
uil/	儘
uil/	賑
uil/	津
uil/	陳
uil/	珍
uil/	辰
uil/	陣
uil/	塵
uil/	震
uil/	進
uil/	診
uil/	秦
uil/	疹
uil/	榛
uil/	晋
uil/	振
uil/	唇
uis/	鑕
uis/	郅
uis/	蒺
uis/	絰
uis/	瓆
uis/	侄
uis/	跌
uis/	膣
uis/	桎
uis/	帙
uis/	垤
uis/	姪
uis/	蛭
uis/	迭
uis/	窒
uis/	秩
uis/	質
uis/	疾
uis/	嫉
uis/	叱
uio/	鴆
uio/	斟
uio/	朕
uia/	鏶
uia/	潗
uia/	戢
uia/	咠
uia/	緝
uia/	什
uia/	集
uia/	輯
uia/	執
uiq/	瞪
uiq/	癥
uiq/	瀓
uiq/	徵
uiq/	澂
uiq/	懲
uiq/	澄
dk/	硨
dk/	徣
dk/	佽
dk/	奓
dk/	蹉
dk/	箚
dk/	磋
dk/	槎
dk/	岔
dk/	嗟
dk/	偖
dk/	侘
dk/	茶
dk/	借
dk/	遮
dk/	車
dk/	次
dk/	瑳
dk/	差
dk/	嵯
dk/	叉
dk/	此
dk/	且
dky/	辶
dky/	斲
dky/	擉
dky/	齪
dky/	鑿
dky/	戳
dky/	着
dky/	捉
dky/	錯
dky/	窄
dky/	搾
dkl/	趲
dkl/	纘
dkl/	瓚
dkl/	璨
dkl/	澯
dkl/	欑
dkl/	攢
dkl/	巑
dkl/	劗
dkl/	儹
dkl/	儧
dkl/	饌
dkl/	鑽
dkl/	贊
dkl/	讚
dkl/	粲
dkl/	竄
dkl/	爨
dkl/	簒
dkl/	撰
dkl/	餐
dkl/	纂
dkl/	燦
dks/	紮
dks/	扎
dks/	刹
dks/	札
dks/	擦
dks/	拶
dks/	察
dko/	黲
dko/	饞
dko/	鑱
dko/	毚
dko/	欃
dko/	攙
dko/	憯
dko/	叅
dko/	儳
dko/	驂
dko/	鏨
dko/	讖
dko/	讒
dko/	譖
dko/	站
dko/	槧
dko/	懺
dko/	慚
dko/	慙
dko/	慘
dko/	巉
dko/	嶄
dko/	塹
dko/	參
dko/	僭
dko/	斬
dkq/	鶬
dkq/	閶
dkq/	窻
dkq/	瑲
dkq/	氅
dkq/	戧
dkq/	惝
dkq/	刱
dkq/	凔
dkq/	傖
dkq/	倀
dkq/	鋹
dkq/	鬯
dkq/	蹌
dkq/	艙
dkq/	窗
dkq/	瘡
dkq/	猖
dkq/	漲
dkq/	滄
dkq/	昶
dkq/	敞
dkq/	搶
dkq/	愴
dkq/	悵
dkq/	倡
dkq/	脹
dkq/	暢
dkq/	蒼
dkq/	窓
dkq/	槍
dkq/	倉
dkq/	創
dkq/	椙
dkq/	菖
dkq/	昌
dkq/	彰
dkq/	廠
dkq/	娼
dkq/	唱
dkq/	錆
dh/	茝
dh/	棌
dh/	埰
dh/	寀
dh/	釵
dh/	蔡
dh/	綵
dh/	寨
dh/	責
dh/	菜
dh/	砦
dh/	采
dh/	採
dh/	彩
dh/	債
dhy/	蚱
dhy/	笧
dhy/	幘
dhy/	簀
dhy/	磔
dhy/	嘖
dhy/	責
dhy/	冊
dhy/	策
dhy/	柵
dj/	郪
dj/	覷
dj/	褄
dj/	萋
dj/	淒
dj/	悽
dj/	處
dj/	凄
dj/	妻
djy/	摭
djy/	慽
djy/	塉
djy/	坧
djy/	倜
djy/	惕
djy/	陟
djy/	躑
djy/	蹠
djy/	跖
djy/	蜴
djy/	瘠
djy/	滌
djy/	擲
djy/	呎
djy/	剔
djy/	捗
djy/	拓
djy/	脊
djy/	斥
djy/	戚
djy/	隻
djy/	尺
djy/	刺
djl/	靝
djl/	蕆
djl/	蒨
djl/	芊
djl/	臶
djl/	祆
djl/	玔
djl/	洊
djl/	儃
djl/	僢
djl/	俴
djl/	韆
djl/	阡
djl/	闡
djl/	踐
djl/	賤
djl/	荐
djl/	瓩
djl/	濺
djl/	淺
djl/	擅
djl/	喘
djl/	倩
djl/	仟
djl/	天
djl/	辿
djl/	遷
djl/	薦
djl/	舛
djl/	穿
djl/	泉
djl/	川
djl/	千
djl/	蚕
djl/	釧
djl/	串
djl/	粁
djl/	茜
djs/	飻
djs/	歠
djs/	掇
djs/	惙
djs/	埑
djs/	剟
djs/	澈
djs/	喆
djs/	餮
djs/	鐵
djs/	錣
djs/	銕
djs/	輟
djs/	屮
djs/	啜
djs/	凸
djs/	轍
djs/	撤
djs/	徹
djs/	哲
djs/	綴
djo/	襜
djo/	甛
djo/	瀸
djo/	櫼
djo/	惉
djo/	幨
djo/	詹
djo/	諂
djo/	籤
djo/	簽
djo/	簷
djo/	瞻
djo/	沾
djo/	檐
djo/	忝
djo/	僉
djo/	添
djo/	尖
dja/	褺
dja/	怗
dja/	堞
dja/	呫
dja/	倢
dja/	輒
dja/	睫
dja/	疊
dja/	貼
dja/	諜
dja/	牒
dja/	帖
dja/	喋
dja/	捷
dja/	妾
djq/	鶄
djq/	圊
djq/	凊
djq/	靑
djq/	淸
djq/	蜻
djq/	菁
djq/	聽
djq/	廳
djq/	青
djq/	請
djq/	晴
djq/	鯖
dp/	髰
dp/	蕞
dp/	殢
dp/	彘
dp/	體
dp/	靆
dp/	遞
dp/	軆
dp/	蔕
dp/	蒂
dp/	砌
dp/	滯
dp/	涕
dp/	棣
dp/	嚏
dp/	諦
dp/	締
dp/	剃
dp/	逮
dp/	替
dp/	切
dn/	顦
dn/	鍫
dn/	醮
dn/	軺
dn/	趠
dn/	譙
dn/	苕
dn/	耖
dn/	綃
dn/	燋
dn/	怊
dn/	嶕
dn/	岧
dn/	嫶
dn/	噍
dn/	僬
dn/	偢
dn/	齠
dn/	鷦
dn/	髫
dn/	鈔
dn/	醋
dn/	迢
dn/	貂
dn/	誚
dn/	艸
dn/	稍
dn/	炒
dn/	椒
dn/	杪
dn/	憔
dn/	愀
dn/	悄
dn/	峭
dn/	屮
dn/	勦
dn/	劭
dn/	剿
dn/	秒
dn/	超
dn/	草
dn/	礎
dn/	楚
dn/	酢
dn/	鞘
dn/	蕉
dn/	肖
dn/	礁
dn/	硝
dn/	焦
dn/	樵
dn/	梢
dn/	招
dn/	抄
dn/	哨
dn/	初
dn/	鍬
dny/	薥
dny/	爥
dny/	曯
dny/	髑
dny/	躅
dny/	觸
dny/	蜀
dny/	矚
dny/	矗
dny/	囑
dny/	促
dny/	燭
dnl/	邨
dnl/	忖
dnl/	村
dnl/	寸
dnl/	吋
dnq/	驄
dnq/	騘
dnq/	鏦
dnq/	蔥
dnq/	蓯
dnq/	憁
dnq/	悤
dnq/	摠
dnq/	聰
dnq/	總
dnq/	葱
dnq/	塚
dnq/	寵
dnq/	叢
dnq/	銃
dnks/	撮
des/	撮
dni/	脧
dni/	縗
dni/	磪
dni/	璀
dni/	漼
dni/	嘬
dni/	榱
dni/	摧
dni/	崔
dni/	最
dni/	催
dx/	脧
dx/	縗
dx/	磪
dx/	璀
dx/	漼
dx/	嘬
dx/	榱
dx/	摧
dx/	崔
dx/	最
dx/	催
dt/	麤
dt/	麄
dt/	鶵
dt/	鶖
dt/	鵻
dt/	魋
dt/	騶
dt/	縐
dt/	簉
dt/	箠
dt/	瘳
dt/	搥
dt/	揫
dt/	僦
dt/	鰌
dt/	騅
dt/	鞦
dt/	隹
dt/	陬
dt/	鄒
dt/	蒭
dt/	芻
dt/	縋
dt/	箒
dt/	龝
dt/	皺
dt/	甃
dt/	湫
dt/	樞
dt/	楸
dt/	捶
dt/	惆
dt/	帚
dt/	娵
dt/	啾
dt/	萩
dt/	鎚
dt/	追
dt/	椎
dt/	墜
dt/	抽
dt/	雛
dt/	趨
dt/	錘
dt/	錐
dt/	推
dt/	諏
dt/	醜
dt/	酋
dt/	秋
dt/	鰍
dty/	鼀
dty/	蹜
dty/	豖
dty/	妯
dty/	蹙
dty/	舳
dty/	逐
dty/	蓄
dty/	筑
dty/	畜
dty/	築
dty/	縮
dty/	祝
dty/	蹴
dty/	軸
dty/	竺
dty/	丑
dtl/	瑃
dtl/	椿
dtl/	春
dts/	秫
dts/	黜
dts/	朮
dts/	出
dtq/	珫
dtq/	忡
dtq/	蟲
dtq/	冲
dtq/	衷
dtq/	忠
dtq/	衝
dtq/	充
dtq/	沖
dtp/	顇
dtp/	疩
dtp/	贅
dtp/	萃
dtp/	膵
dtp/	瘁
dtp/	揣
dtp/	惴
dtp/	悴
dz/	顇
dz/	疩
dz/	贅
dz/	萃
dz/	膵
dz/	瘁
dz/	揣
dz/	惴
dz/	悴
dti/	冣
dti/	驟
dti/	醉
dti/	聚
dti/	毳
dti/	橇
dti/	娶
dti/	嘴
dti/	鷲
dti/	脆
dti/	翠
dti/	炊
dti/	吹
dti/	臭
dti/	就
dti/	趣
dti/	取
dd/	冣
dd/	驟
dd/	醉
dd/	聚
dd/	毳
dd/	橇
dd/	娶
dd/	嘴
dd/	鷲
dd/	脆
dd/	翠
dd/	炊
dd/	吹
dd/	臭
dd/	就
dd/	趣
dd/	取
dvy/	昃
dvy/	惻
dvy/	廁
dvy/	厠
dvy/	仄
dvy/	測
dvy/	側
dvq/	層
di/	鴙
di/	阤
di/	跱
di/	菑
di/	絺
di/	痓
di/	淄
di/	哆
di/	寘
di/	齒
di/	鵄
di/	鴟
di/	鯔
di/	雉
di/	錙
di/	輜
di/	豸
di/	褫
di/	蚩
di/	緻
di/	緇
di/	穉
di/	癡
di/	畤
di/	熾
di/	梔
di/	幟
di/	巵
di/	峙
di/	嗤
di/	卮
di/	侈
di/	薙
di/	馳
di/	致
di/	置
di/	稚
di/	痴
di/	恥
di/	値
di/	痔
di/	治
diy/	敕
diy/	飭
diy/	勅
diy/	則
dil/	藽
dil/	櫬
dil/	齔
dil/	襯
dil/	親
dis/	柒
dis/	漆
dis/	七
dio/	鋟
dio/	郴
dio/	琛
dio/	沉
dio/	寖
dio/	駸
dio/	鍼
dio/	椹
dio/	忱
dio/	寢
dio/	枕
dio/	沈
dio/	針
dio/	浸
dio/	侵
dio/	砧
dia/	蟄
diq/	噲
diq/	稱
diq/	夬
diq/	秤
znh/	快
zs/	快
ek/	鼉
ek/	鮀
ek/	駞
ek/	馱
ek/	跎
ek/	拖
ek/	拕
ek/	垞
ek/	鴕
ek/	駝
ek/	躱
ek/	沱
ek/	橢
ek/	朶
ek/	墮
ek/	咤
ek/	佗
ek/	詫
ek/	陀
ek/	楕
ek/	舵
ek/	柁
ek/	打
ek/	惰
ek/	妥
ek/	唾
ek/	他
eky/	逴
eky/	踔
eky/	蘀
eky/	籜
eky/	矺
eky/	琸
eky/	涿
eky/	沰
eky/	橐
eky/	晫
eky/	坼
eky/	柝
eky/	拆
eky/	倬
eky/	度
eky/	擢
eky/	濁
eky/	鐸
eky/	託
eky/	琢
eky/	濯
eky/	拓
eky/	托
eky/	啄
eky/	卓
ekl/	驒
ekl/	癱
ekl/	憻
ekl/	殫
ekl/	攤
ekl/	憚
ekl/	彈
ekl/	灘
ekl/	呑
ekl/	誕
ekl/	綻
ekl/	炭
ekl/	歎
ekl/	坦
ekl/	嘆
eks/	脫
eks/	侻
eks/	奪
eko/	忐
eko/	嗿
eko/	酖
eko/	貪
eko/	眈
eko/	耽
eko/	探
eka/	塌
eka/	傝
eka/	榻
eka/	搨
eka/	搭
eka/	塔
ekq/	碭
ekq/	燙
ekq/	蘯
ekq/	盪
ekq/	帑
ekq/	蕩
ekq/	糖
ekq/	湯
ekq/	宕
eh/	邰
eh/	迨
eh/	跆
eh/	孡
eh/	娧
eh/	埭
eh/	駘
eh/	颱
eh/	笞
eh/	抬
eh/	兌
eh/	殆
eh/	台
eh/	苔
eh/	胎
eh/	泰
eh/	態
eh/	怠
eh/	駄
eh/	汰
eh/	太
ehy/	澤
ehy/	擇
ehy/	宅
ehq/	牚
ehq/	撑
ehq/	撐
ej/	攄
en/	討
en/	土
en/	吐
en/	兎
enl/	噋
enl/	瓲
enl/	噸
enq/	筩
enq/	慟
enq/	恫
enq/	樋
enq/	洞
enq/	統
enq/	筒
enq/	通
enq/	痛
enq/	桶
eni/	頹
eni/	隤
eni/	褪
eni/	槌
eni/	退
eni/	腿
eni/	堆
ex/	頹
ex/	隤
ex/	褪
ex/	槌
ex/	退
ex/	腿
ex/	堆
et/	妒
et/	鬪
et/	骰
et/	渝
et/	偸
et/	透
et/	投
et/	套
et/	妬
etq/	佟
evy/	忒
evy/	慝
evy/	特
evo/	闖
xk/	鄱
xk/	皤
xk/	爸
xk/	灞
xk/	岥
xk/	妑
xk/	吧
xk/	叵
xk/	跛
xk/	葩
xk/	菠
xk/	耙
xk/	笆
xk/	玻
xk/	爬
xk/	擺
xk/	怕
xk/	坡
xk/	簸
xk/	罷
xk/	芭
xk/	婆
xk/	破
xk/	琶
xk/	派
xk/	波
xk/	杷
xk/	播
xk/	把
xk/	巴
xk/	頗
xkl/	辦
xkl/	汴
xkl/	鈑
xkl/	瓣
xkl/	販
xkl/	版
xkl/	板
xkl/	判
xkl/	阪
xkl/	坂
xks/	汃
xks/	朳
xks/	叭
xks/	八
xks/	捌
xh/	浿
xh/	霈
xh/	珮
xh/	沛
xh/	霸
xh/	旆
xh/	悖
xh/	孛
xh/	佩
xh/	稗
xh/	狽
xh/	牌
xh/	敗
xh/	覇
xh/	貝
xh/	唄
xhq/	蟛
xhq/	蟚
xhq/	祊
xhq/	砰
xhq/	澎
xhq/	彭
xhq/	膨
xhq/	烹
xfy/	愎
xgl/	萹
xgl/	艑
xgl/	緶
xgl/	惼
xgl/	徧
xgl/	匾
xgl/	騙
xgl/	諞
xgl/	褊
xgl/	蝙
xgl/	翩
xgl/	扁
xgl/	鞭
xgl/	便
xgl/	遍
xgl/	編
xgl/	篇
xgl/	片
xgl/	偏
xgo/	窆
xgo/	砭
xgo/	貶
xgq/	蓱
xgq/	枰
xgq/	抨
xgq/	鮃
xgq/	萍
xgq/	苹
xgq/	泙
xgq/	怦
xgq/	平
xgq/	評
xgq/	坪
xpp/	獘
xpp/	狴
xpp/	癈
xpp/	斃
xpp/	敝
xpp/	廢
xpp/	嬖
xpp/	吠
xpp/	陛
xpp/	閉
xpp/	蔽
xpp/	弊
xpp/	幣
xpp/	肺
xq/	獘
xq/	狴
xq/	癈
xq/	斃
xq/	敝
xq/	廢
xq/	嬖
xq/	吠
xq/	陛
xq/	閉
xq/	蔽
xq/	弊
xq/	幣
xq/	肺
xn/	炰
xn/	曓
xn/	晡
xn/	儤
xn/	佈
xn/	誧
xn/	鯆
xn/	鮑
xn/	餔
xn/	鉋
xn/	逋
xn/	袍
xn/	苞
xn/	舖
xn/	脯
xn/	疱
xn/	炮
xn/	抛
xn/	哺
xn/	咆
xn/	匏
xn/	匍
xn/	暴
xn/	飽
xn/	褒
xn/	胞
xn/	砲
xn/	泡
xn/	抱
xn/	庖
xn/	包
xn/	捕
xn/	圃
xn/	鋪
xn/	葡
xn/	怖
xn/	布
xn/	蒲
xn/	鞄
xn/	浦
xny/	輻
xny/	瀑
xny/	暴
xny/	幅
xny/	爆
xny/	曝
xm/	飇
xm/	鑣
xm/	鏢
xm/	裱
xm/	熛
xm/	摽
xm/	嘌
xm/	勡
xm/	僄
xm/	鰾
xm/	髟
xm/	驃
xm/	飄
xm/	縹
xm/	殍
xm/	慓
xm/	嫖
xm/	剽
xm/	豹
xm/	表
xm/	票
xm/	瓢
xm/	漂
xm/	標
xm/	彪
xm/	俵
xm/	杓
xto/	禀
xto/	稟
xto/	品
xtq/	葑
xtq/	馮
xtq/	諷
xtq/	瘋
xtq/	豊
xtq/	風
xtq/	楓
xi/	髲
xi/	詖
xi/	鞁
xi/	陂
xi/	辟
xi/	避
xi/	被
xi/	皮
xi/	疲
xi/	披
xi/	彼
xiy/	腷
xis/	駜
xis/	馝
xis/	韠
xis/	鞸
xis/	觱
xis/	蓽
xis/	苾
xis/	罼
xis/	珌
xis/	滭
xis/	咇
xis/	佖
xis/	鵯
xis/	蹕
xis/	篳
xis/	筆
xis/	畢
xis/	必
xis/	弼
xis/	疋
xis/	匹
xis/	泌
xia/	偪
xia/	乏
xia/	逼
wk/	瘕
wk/	昰
wk/	懗
wk/	岈
wk/	煆
wk/	鰕
wk/	鍜
wk/	遐
wk/	罅
wk/	瑕
wk/	廈
wk/	呀
wk/	厦
wk/	嚇
wk/	賀
wk/	霞
wk/	蝦
wk/	荷
wk/	河
wk/	夏
wk/	何
wk/	下
wky/	郝
wky/	确
wky/	皬
wky/	嗀
wky/	鷽
wky/	謔
wky/	瘧
wky/	狢
wky/	涸
wky/	學
wky/	壑
wky/	鶴
wky/	虐
wky/	鷳
wky/	閈
wky/	暵
wky/	僩
wky/	閒
wky/	鼾
wky/	駻
wky/	罕
wky/	瀚
wky/	澣
wky/	旱
wky/	捍
wky/	悍
wky/	嫻
wky/	嫺
wky/	恨
wky/	限
wky/	韓
wky/	閑
wky/	翰
wky/	漢
wky/	汗
wky/	寒
wks/	瞎
wks/	轄
wks/	割
wko/	闞
wko/	轞
wko/	諴
wko/	菡
wko/	鹹
wko/	陷
wko/	銜
wko/	莟
wko/	緘
wko/	涵
wko/	檻
wko/	喊
wko/	啣
wko/	咸
wko/	函
wko/	含
wko/	艦
wka/	郃
wka/	榼
wka/	柙
wka/	嗑
wka/	匌
wka/	陜
wka/	闔
wka/	盒
wka/	盍
wka/	溘
wka/	哈
wka/	蛤
wka/	合
wka/	閤
wkq/	缿
wkq/	炕
wkq/	姮
wkq/	夯
wkq/	沆
wkq/	頏
wkq/	肛
wkq/	缸
wkq/	恆
wkq/	嫦
wkq/	伉
wkq/	亢
wkq/	項
wkq/	降
wkq/	行
wkq/	航
wkq/	港
wkq/	杭
wkq/	抗
wkq/	恒
wkq/	巷
wkq/	桁
wh/	頦
wh/	痎
wh/	瑎
wh/	獬
wh/	瀣
wh/	欬
wh/	嶰
wh/	咍
wh/	駭
wh/	醢
wh/	邂
wh/	諧
wh/	薤
wh/	楷
wh/	懈
wh/	廨
wh/	孩
wh/	奚
wh/	垓
wh/	偕
wh/	鮭
wh/	骸
wh/	該
wh/	害
wh/	咳
wh/	蟹
wh/	海
wh/	解
wh/	亥
why/	翮
why/	覈
why/	核
why/	劾
whq/	荇
whq/	悻
whq/	行
whq/	幸
whq/	倖
whq/	杏
wfq/	鄉
wfq/	薌
wfq/	珦
wfq/	鄕
wfq/	餉
wfq/	嚮
wfq/	香
wfq/	向
wfq/	饗
wfq/	響
wfq/	享
wj/	虛
wj/	噓
wj/	歔
wj/	墟
wj/	許
wjl/	櫶
wjl/	攇
wjl/	幰
wjl/	巚
wjl/	獻
wjl/	軒
wjl/	憲
wjs/	歇
wjo/	玁
wjo/	獫
wjo/	驗
wjo/	險
wjo/	嶮
wgy/	爀
wgy/	焱
wgy/	弈
wgy/	鬩
wgy/	洫
wgy/	奕
wgy/	革
wgy/	赫
wgl/	駽
wgl/	誢
wgl/	翾
wgl/	繯
wgl/	睍
wgl/	琄
wgl/	玹
wgl/	泫
wgl/	晛
wgl/	昡
wgl/	峴
wgl/	嬛
wgl/	儇
wgl/	鋗
wgl/	炫
wgl/	顯
wgl/	鉉
wgl/	衒
wgl/	蜆
wgl/	縣
wgl/	眩
wgl/	痃
wgl/	俔
wgl/	舷
wgl/	絃
wgl/	現
wgl/	玄
wgl/	弦
wgl/	賢
wgl/	見
wgl/	県
wgl/	懸
wgl/	絢
wgs/	趐
wgs/	絜
wgs/	孑
wgs/	頁
wgs/	血
wgs/	穴
wgo/	嫌
wga/	頰
wga/	愜
wga/	悏
wga/	埉
wga/	匧
wga/	俠
wga/	鋏
wga/	莢
wga/	篋
wga/	狹
wga/	浹
wga/	挾
wga/	恊
wga/	峽
wga/	夾
wga/	脇
wga/	脅
wga/	協
wga/	叶
wgq/	陘
wgq/	鎣
wgq/	邢
wgq/	逈
wgq/	詗
wgq/	珩
wgq/	熒
wgq/	灐
wgq/	滎
wgq/	泂
wgq/	娙
wgq/	瀅
wgq/	迥
wgq/	螢
wgq/	瑩
wgq/	炯
wgq/	夐
wgq/	衡
wgq/	荊
wgq/	形
wgq/	型
wgq/	兄
wgq/	刑
wgq/	亨
wgq/	馨
wpp/	謑
wpp/	槥
wpp/	暳
wpp/	徯
wpp/	寭
wpp/	嘒
wpp/	傒
wpp/	譿
wpp/	蕙
wpp/	鞋
wpp/	醯
wpp/	蹊
wpp/	盻
wpp/	惠
wpp/	彗
wpp/	兮
wpp/	慧
wq/	謑
wq/	槥
wq/	暳
wq/	徯
wq/	寭
wq/	嘒
wq/	傒
wq/	譿
wq/	蕙
wq/	鞋
wq/	醯
wq/	蹊
wq/	盻
wq/	惠
wq/	彗
wq/	兮
wq/	慧
wn/	鬍
wn/	頀
wn/	聕
wn/	箎
wn/	祜
wn/	猢
wn/	灝
wn/	濩
wn/	澔
wn/	滈
wn/	戶
wn/	岵
wn/	嫮
wn/	嫭
wn/	嘷
wn/	儫
wn/	顥
wn/	皞
wn/	皜
wn/	淏
wn/	餬
wn/	鎬
wn/	扈
wn/	蝴
wn/	號
wn/	蒿
wn/	葫
wn/	皓
wn/	瓠
wn/	琥
wn/	犒
wn/	滸
wn/	滬
wn/	沍
wn/	毫
wn/	晧
wn/	昊
wn/	怙
wn/	壺
wn/	冱
wn/	縞
wn/	豪
wn/	濠
wn/	壕
wn/	浩
wn/	好
wn/	醐
wn/	護
wn/	瑚
wn/	互
wn/	虎
wn/	胡
wn/	糊
wn/	狐
wn/	湖
wn/	弧
wn/	呼
wn/	乎
wn/	芦
wny/	惑
wny/	酷
wny/	或
wnl/	閽
wnl/	惛
wnl/	圂
wnl/	琿
wnl/	焜
wnl/	溷
wnl/	渾
wnl/	魂
wnl/	混
wnl/	昏
wnl/	婚
wns/	囫
wns/	笏
wns/	惚
wns/	忽
wnq/	篊
wnq/	烘
wnq/	澒
wnq/	晎
wnq/	鉷
wnq/	鬨
wnq/	訌
wnq/	泓
wnq/	汞
wnq/	哄
wnq/	虹
wnq/	鴻
wnq/	紅
wnq/	洪
wnq/	弘
wnk/	龢
wnk/	驊
wnk/	畵
wnk/	擭
wnk/	嬅
wnk/	婲
wnk/	俰
wnk/	譁
wnk/	畫
wnk/	話
wnk/	和
wnk/	靴
wnk/	樺
wnk/	貨
wnk/	嘩
wnk/	華
wnk/	花
wnk/	禾
wnk/	禍
wnk/	火
wnk/	化
we/	龢
we/	驊
we/	畵
we/	擭
we/	嬅
we/	婲
we/	俰
we/	譁
we/	畫
we/	話
we/	和
we/	靴
we/	樺
we/	貨
we/	嘩
we/	華
we/	花
we/	禾
we/	禍
we/	火
we/	化
wnky/	鑊
wnky/	礭
wnky/	碻
wnky/	矡
wnky/	矍
wnky/	攫
wnky/	擴
wnky/	穫
wnky/	確
wnky/	廓
wey/	鑊
wey/	礭
wey/	碻
wey/	矡
wey/	矍
wey/	攫
wey/	擴
wey/	穫
wey/	確
wey/	廓
wnkl/	轘
wnkl/	絙
wnkl/	紈
wnkl/	瓛
wnkl/	擐
wnkl/	鍰
wnkl/	睆
wnkl/	晥
wnkl/	鰥
wnkl/	鬟
wnkl/	驩
wnkl/	鐶
wnkl/	豢
wnkl/	皖
wnkl/	煥
wnkl/	渙
wnkl/	歡
wnkl/	懽
wnkl/	寰
wnkl/	宦
wnkl/	奐
wnkl/	幻
wnkl/	丸
wnkl/	還
wnkl/	環
wnkl/	桓
wnkl/	換
wnkl/	患
wnkl/	喚
wel/	轘
wel/	絙
wel/	紈
wel/	瓛
wel/	擐
wel/	鍰
wel/	睆
wel/	晥
wel/	鰥
wel/	鬟
wel/	驩
wel/	鐶
wel/	豢
wel/	皖
wel/	煥
wel/	渙
wel/	歡
wel/	懽
wel/	寰
wel/	宦
wel/	奐
wel/	幻
wel/	丸
wel/	還
wel/	環
wel/	桓
wel/	換
wel/	患
wel/	喚
wnks/	闊
wnks/	豁
wnks/	蛞
wnks/	猾
wnks/	滑
wnks/	活
wes/	闊
wes/	豁
wes/	蛞
wes/	猾
wes/	滑
wes/	活
wnkq/	黃
wnkq/	貺
wnkq/	璜
wnkq/	瑝
wnkq/	潢
wnkq/	榥
wnkq/	怳
wnkq/	媓
wnkq/	喤
wnkq/	鎤
wnkq/	愰
wnkq/	隍
wnkq/	遑
wnkq/	蝗
wnkq/	肓
wnkq/	簧
wnkq/	篁
wnkq/	煌
wnkq/	滉
wnkq/	湟
wnkq/	晄
wnkq/	惶
wnkq/	恍
wnkq/	徨
wnkq/	凰
wnkq/	幌
wnkq/	荒
wnkq/	皇
wnkq/	晃
wnkq/	慌
wnkq/	況
weq/	黃
weq/	貺
weq/	璜
weq/	瑝
weq/	潢
weq/	榥
weq/	怳
weq/	媓
weq/	喤
weq/	鎤
weq/	愰
weq/	隍
weq/	遑
weq/	蝗
weq/	肓
weq/	簧
weq/	篁
weq/	煌
weq/	滉
weq/	湟
weq/	晄
weq/	惶
weq/	恍
weq/	徨
weq/	凰
weq/	幌
weq/	荒
weq/	皇
weq/	晃
weq/	慌
weq/	況
wnh/	噦
ws/	噦
wni/	頮
wni/	盔
wni/	澮
wni/	滙
wni/	佪
wni/	洄
wni/	鱠
wni/	迴
wni/	誨
wni/	詼
wni/	蛔
wni/	茴
wni/	膾
wni/	繪
wni/	獪
wni/	淮
wni/	檜
wni/	懷
wni/	徊
wni/	匯
wni/	會
wni/	賄
wni/	栃
wni/	灰
wni/	晦
wni/	恢
wni/	悔
wni/	廻
wni/	回
wx/	頮
wx/	盔
wx/	澮
wx/	滙
wx/	佪
wx/	洄
wx/	鱠
wx/	迴
wx/	誨
wx/	詼
wx/	蛔
wx/	茴
wx/	膾
wx/	繪
wx/	獪
wx/	淮
wx/	檜
wx/	懷
wx/	徊
wx/	匯
wx/	會
wx/	賄
wx/	栃
wx/	灰
wx/	晦
wx/	恢
wx/	悔
wx/	廻
wx/	回
wniy/	嚄
wniy/	獲
wniy/	劃
wxy/	嚄
wxy/	獲
wxy/	劃
wniq/	鐄
wniq/	鈜
wniq/	澋
wniq/	宖
wniq/	橫
wniq/	黌
wxq/	鐄
wxq/	鈜
wxq/	澋
wxq/	宖
wxq/	橫
wxq/	黌
wm/	餚
wm/	虓
wm/	熇
wm/	涍
wm/	殽
wm/	斅
wm/	崤
wm/	皛
wm/	驍
wm/	爻
wm/	淆
wm/	梟
wm/	曉
wm/	效
wm/	囂
wm/	嚆
wm/	哮
wm/	傚
wm/	肴
wm/	酵
wm/	孝
wt/	餱
wt/	酗
wt/	譃
wt/	詡
wt/	珝
wt/	帿
wt/	堠
wt/	垕
wt/	喣
wt/	逅
wt/	篌
wt/	猴
wt/	煦
wt/	嗅
wt/	吼
wt/	吽
wt/	喉
wt/	后
wt/	厚
wt/	候
wt/	侯
wt/	後
wt/	朽
wtl/	鑂
wtl/	纁
wtl/	獯
wtl/	爋
wtl/	欻
wtl/	曛
wtl/	壎
wtl/	塤
wtl/	薰
wtl/	焄
wtl/	勛
wtl/	葷
wtl/	燻
wtl/	熏
wtl/	暈
wtl/	勳
wtl/	訓
wtq/	薨
wtjl/	諼
wtjl/	芔
wtjl/	煊
wtjl/	烜
wtjl/	毁
wtjl/	楦
wtjl/	諠
wtjl/	燬
wtjl/	暄
wtjl/	喧
wtjl/	萱
wal/	諼
wal/	芔
wal/	煊
wal/	烜
wal/	毁
wal/	楦
wal/	諠
wal/	燬
wal/	暄
wal/	喧
wal/	萱
wtp/	虺
wtp/	喙
wtp/	卉
wtp/	虫
wz/	虺
wz/	喙
wz/	卉
wz/	虫
wti/	翬
wti/	煇
wti/	撝
wti/	諱
wti/	麾
wti/	暉
wti/	彙
wti/	輝
wti/	徽
wti/	揮
wd/	翬
wd/	煇
wd/	撝
wd/	諱
wd/	麾
wd/	暉
wd/	彙
wd/	輝
wd/	徽
wd/	揮
wr/	鵂
wr/	髹
wr/	隳
wr/	擕
wr/	咻
wr/	虧
wr/	烋
wr/	畦
wr/	携
wr/	休
wrs/	卹
wrs/	鷸
wrs/	譎
wrs/	恤
wrq/	胷
wrq/	洶
wrq/	恟
wrq/	匈
wrq/	胸
wrq/	凶
wrq/	兇
wvy/	黑
wvl/	訢
wvl/	焮
wvl/	炘
wvl/	昕
wvl/	釁
wvl/	掀
wvl/	忻
wvl/	很
wvl/	痕
wvl/	欣
wvs/	齕
wvs/	紇
wvs/	疙
wvs/	汔
wvs/	仡
wvs/	訖
wvs/	屹
wvs/	迄
wvs/	吃
wvo/	歆
wvo/	廞
wvo/	欠
wvo/	欽
wva/	翖
wva/	潝
wva/	噏
wva/	翕
wva/	洽
wva/	歙
wva/	吸
wva/	恰
wvq/	興
wvi/	餼
wvi/	豨
wvi/	爔
wvi/	熺
wvi/	戱
wvi/	悕
wvi/	姬
wvi/	囍
wvi/	嘻
wvi/	凞
wvi/	暿
wvi/	憘
wvi/	熙
wvi/	羲
wvi/	禧
wvi/	犧
wvi/	燹
wvi/	熹
wvi/	欷
wvi/	曦
wvi/	晞
wvi/	戲
wvi/	憙
wvi/	噫
wvi/	唏
wvi/	咥
wvi/	僖
wvi/	稀
wvi/	希
wvi/	嬉
wvi/	喜
wl/	餼
wl/	豨
wl/	爔
wl/	熺
wl/	戱
wl/	悕
wl/	姬
wl/	囍
wl/	嘻
wl/	凞
wl/	暿
wl/	憘
wl/	熙
wl/	羲
wl/	禧
wl/	犧
wl/	燹
wl/	熹
wl/	欷
wl/	曦
wl/	晞
wl/	戲
wl/	憙
wl/	噫
wl/	唏
wl/	咥
wl/	僖
wl/	稀
wl/	希
wl/	嬉
wl/	喜
wis/	犵
wis/	黠
wis/	頡
wis/	襭
wis/	纈
wis/	詰
#異讀及頭音規則等
qgl/	秊
qgl/	撚
qgl/	年
qgo/	捻
qgo/	念
sgq/	寧
qgq/	寧
qr/	紐
qr/	杻
qi/	泥
qiy/	溺
qiy/	匿
lk/	懶
lk/	喇
lk/	裸
lk/	螺
lk/	蘿
lk/	羅
lk/	癩
lk/	邏
sky/	諾
lky/	落
lky/	珞
lky/	烙
lky/	洛
lky/	駱
lky/	酪
lkl/	蘭
lkl/	爛
lkl/	欄
lkl/	卵
lkl/	亂
lkl/	鸞
lko/	襤
lko/	藍
lko/	濫
lko/	嵐
lka/	蠟
lka/	臘
lka/	拉
lkq/	狼
lkq/	浪
lkq/	朗
lkq/	廊
lh/	來
lhq/	冷
qfy/	略
qfy/	掠
qfq/	量
qfq/	諒
qfq/	良
qfq/	糧
qfq/	梁
qfq/	凉
qfq/	兩
qfq/	亮
qg/	黎
qg/	麗
qg/	驪
qg/	閭
qg/	礪
qg/	濾
qg/	旅
qg/	廬
qg/	呂
qg/	勵
qgy/	轢
qgy/	歷
qgy/	曆
qgy/	力
qgl/	鍊
qgl/	連
qgl/	輦
qgl/	蓮
qgl/	聯
qgl/	練
qgl/	璉
qgl/	煉
qgl/	漣
qgl/	戀
qgl/	憐
qgs/	裂
qgs/	烈
qgs/	劣
qgs/	列
qgo/	簾
qgo/	殮
qgo/	廉
qga/	獵
qgq/	領
qgq/	靈
qgq/	零
qgq/	鈴
qgq/	聆
qgq/	羚
qgq/	玲
qgq/	怜
qgq/	嶺
qgq/	囹
qgq/	令
qpp/	醴
qpp/	禮
qpp/	例
qq/	醴
qq/	禮
qq/	例
ln/	路
ln/	虜
ln/	蘆
ln/	老
ln/	盧
ln/	爐
ln/	櫓
ln/	擄
#ln/	怒
ln/	勞
ln/	鷺
ln/	魯
ln/	露
lny/	菉
lny/	綠
lny/	祿
lny/	碌
lny/	鹿
lny/	錄
lnl/	論
lnq/	聾
lnq/	籠
lnq/	弄
lnq/	壟
lni/	賂
lni/	磊
lni/	牢
lni/	雷
lx/	賂
lx/	磊
lx/	牢
lx/	雷
qm/	遼
qm/	蓼
qm/	療
qm/	燎
qm/	料
qm/	寮
qm/	僚
qm/	了
qmq/	龍
lt/	縷
lt/	累
lt/	漏
lt/	淚
lt/	樓
lt/	屢
lt/	壘
lt/	陋
qr/	類
qr/	硫
qr/	留
qr/	琉
qr/	溜
qr/	流
qr/	柳
qr/	劉
qry/	陸
qry/	戮
qry/	六
qrl/	輪
qrl/	淪
qrl/	崙
qrl/	倫
qrs/	栗
qrs/	慄
qrs/	律
qrq/	隆
lvy/	肋
lvy/	勒
lvo/	凜
lvo/	菱
lvo/	綾
lvo/	稜
lvo/	凌
lvo/	陵
qi/	離
qi/	里
qi/	裡
qi/	裏
qi/	罹
qi/	痢
si/	異
qi/	理
qi/	梨
qi/	李
qi/	履
qi/	吏
qi/	利
qil/	麟
qil/	鱗
qil/	隣
qil/	藺
qil/	璘
qil/	燐
qil/	吝
qio/	臨
qio/	淋
qio/	林
qia/	粒
qia/	笠
qia/	立
qm/	尿
skl/	丹
sn/	怒
#推導漢字音
#qvl/	嗯
#ska/	啦
#xk/	吧
ln/	孬
ohq/	掹
###韓文漢字對映結束
##韓文單音啟始
#####韓語單字母直出開始#######
y	ㄱ
l	ㄴ
c	ㄷ
s	ㄹ
o	ㅁ
a	ㅂ
b	ㅅ
q	ㅇ
u	ㅈ
d	ㅊ
z	ㅋ
e	ㅌ
x	ㅍ
w	ㅎ
yy	ㄲ
cc	ㄸ
aa	ㅃ
bb	ㅆ
uu	ㅉ
k	ㅏ
f	ㅑ
j	ㅓ
g	ㅕ
n	ㅗ
m	ㅛ
t	ㅜ
r	ㅠ
v	ㅡ
i	ㅣ
h	ㅐ
hh	ㅒ
p	ㅔ
pp	ㅖ
nk	ㅘ
nh	ㅙ
ni	ㅚ
tj	ㅝ
tp	ㅞ
ti	ㅟ
vi	ㅢ
yb	ㄳ
lu	ㄵ
lw	ㄶ
sy	ㄺ
so	ㄻ
sa	ㄼ
sb	ㄽ
se	ㄾ
sx	ㄿ
sw	ㅀ
ab	ㅄ
#####韓語單字母直出結束#######
#韓文現代使用單音：後綴加斜線
y/	ㄱ
l/	ㄴ
c/	ㄷ
s/	ㄹ
o/	ㅁ
a/	ㅂ
b/	ㅅ
q/	ㅇ
u/	ㅈ
d/	ㅊ
z/	ㅋ
e/	ㅌ
x/	ㅍ
w/	ㅎ
yy/	ㄲ
cc/	ㄸ
aa/	ㅃ
bb/	ㅆ
uu/	ㅉ
k/	ㅏ
f/	ㅑ
j/	ㅓ
g/	ㅕ
n/	ㅗ
m/	ㅛ
t/	ㅜ
r/	ㅠ
v/	ㅡ
i/	ㅣ
h/	ㅐ
hh/	ㅒ
p/	ㅔ
pp/	ㅖ
nk/	ㅘ
nh/	ㅙ
ni/	ㅚ
tj/	ㅝ
tp/	ㅞ
ti/	ㅟ
vi/	ㅢ
yb/	ㄳ
lu/	ㄵ
lw/	ㄶ
sy/	ㄺ
so/	ㄻ
sa/	ㄼ
sb/	ㄽ
se/	ㄾ
sx/	ㄿ
sw/	ㅀ
ab/	ㅄ
#韓文現代使用單音：前綴加斜線
/y	ㄱ
/l	ㄴ
/c	ㄷ
/s	ㄹ
/o	ㅁ
/a	ㅂ
/b	ㅅ
/q	ㅇ
/u	ㅈ
/d	ㅊ
/z	ㅋ
/e	ㅌ
/x	ㅍ
/w	ㅎ
/yy	ㄲ
/cc	ㄸ
/aa	ㅃ
/bb	ㅆ
/uu	ㅉ
/k	ㅏ
/f	ㅑ
/j	ㅓ
/g	ㅕ
/n	ㅗ
/m	ㅛ
/t	ㅜ
/r	ㅠ
/v	ㅡ
/i	ㅣ
/h	ㅐ
/hh	ㅒ
/p	ㅔ
/pp	ㅖ
/nk	ㅘ
/nh	ㅙ
/ni	ㅚ
/tj	ㅝ
/tp	ㅞ
/ti	ㅟ
/vi	ㅢ
/yb	ㄳ
/lu	ㄵ
/lw	ㄶ
/sy	ㄺ
/so	ㄻ
/sa	ㄼ
/sb	ㄽ
/se	ㄾ
/sx	ㄿ
/sw	ㅀ
/ab	ㅄ
##201610增加修改韓文現代使用單音結束
#韓文古代使用字母(注意有些字母會自動合併還未校正)
/sq	ᄛ
/oq	ㅱ
/aq	ㅸ
/b	ᄼ
/b	ᄾ
/bv	ㅿ
/q	ㆁ
/u	ᅎ
/u	ᅐ
/nb	ᅔ
/nb	ᅕ
/xq	ㆄ
/vq	ㆆ
/ll	ㅥ
/ss	ᄙ
/aaq	ㅹ
/bb	ᄽ
/bb	ᄿ
/qq	ᅇ
/qq	ᇮ
/uu	ᅏ
/uu	ᅑ
/ww	ㆅ
#h66
/ys	ᇃ
/ly	ᄓ
/lc	ㅦ
/la	ᄖ
/lb	ㅧ
/lbv	ㅨ
/le	ᇉ
/cy	ᄗ
/cs	ᇋ
/sl	ᄘ
/sc	ㅪ
/sbv	ㅬ
/sz	ᇘ
/svq	ㅭ
/oy	ᇚ
/os	ᇛ
/oa	ㅮ
/ob	ㅯ
/obv	ㅰ
/od	ᇠ
/ow	ᇡ
/ay	ㅲ
/al	ᄟ
/ac	ㅳ
/as	ᇣ
/au	ㅶ
/ad	ᄨ
/ae	ㅷ
/ax	ᄪ
/aw	ᇥ
/by	ㅺ
/bl	ㅻ
/bc	ㅼ
/bs	ᄰ
/bo	ᄱ
/ba	ㅽ
/bq	ᄵ
/bu	ㅾ
/bd	ᄷ
/bz	ᄸ
/be	ᄹ
/bx	ᄺ
/bw	ᄻ
/qy	ᅁ
/qc	ᅂ
/qo	ᅃ
/qa	ᅄ
/qb	ᅅ
/qbv	ᅆ
/qu	ᅈ
/qd	ᅉ
/qe	ᅊ
/qx	ᅋ
/qy	ᇬ
/qyy	ᇭ
/qb	ㆂ
/qbv	ㆃ
/qz	ᇯ
/uq	ᅍ
/dz	ᅒ
/dw	ᅓ
/xa	ᅖ
/wl	ᇵ
/ws	ᇶ
/wo	ᇷ
/wa	ᇸ
#h-17
/yby	ᇄ
/syb	ㅩ
/scw	ᇏ
/soy	ᇑ
/sob	ᇒ
/sab	ㅫ
/saw	ᇔ
/saq	ᇕ
/sbb	ᇖ
/obb	ᇞ
/aby	ㅴ
/abc	ㅵ
/aba	ᄤ
/abb	ᄥ
/abu	ᄦ
/bay	ᄳ
/bbb	ᄴ
#h43
/iv	ᆜ
/ia	ᆝ
/aa	ᆢ
/kt	ᅷ
/fn	ᅸ
/fm	ᅹ
/jn	ᅺ
/jt	ᅻ
/jv	ᅼ
/gn	ᅽ
/gt	ᅾ
/nj	ᅿ
/np	ᆀ
/npp	ᆁ
/nn	ᆂ
/nt	ᆃ
/mf	ㆇ
/mhh	ㆈ
/mg	ᆆ
/mn	ᆇ
/mi	ㆉ
/tk	ᆉ
/th	ᆊ
/tjv	ᆋ
/tpp	ᆌ
/tt	ᆍ
/rk	ᆎ
/rj	ᆏ
/rp	ᆐ
/rg	ㆊ
/rpp	ㆋ
/rt	ᆓ
/ri	ㆌ
/vt	ᆕ
/vv	ᆖ
/vit	ᆗ
/ik	ᆘ
/if	ᆙ
/in	ᆚ
/it	ᆛ
/aj	ᆟ
/at	ᆠ
/ai	ㆎ
#h2
/qq	ㆀ
/a	ㆍ
##韓文單音結束
###韓文總結束
%chardef end
